GISJOIN,STATEFP,COUNTYFP,TRACTCE,pov_fam_5_17,nonpov_fam_5_17,tot_fam_5_17,Percent_Pov_Fam5_17
G1200010000200,12,1,200,81,67,148,0.5472973
G1200010000301,12,1,301,77,173,250,0.308
G1200010000302,12,1,302,52,141,193,0.26943004
G1200010000400,12,1,400,311,280,591,0.52622676
G1200010000500,12,1,500,128,218,346,0.36994219
G1200010000600,12,1,600,197,216,413,0.47699758
G1200010000700,12,1,700,120,357,477,0.25157234
G1200010000806,12,1,806,0,31,31,0
G1200010000808,12,1,808,17,64,81,0.20987654
G1200010000809,12,1,809,6,60,66,0.090909094
G1200010000901,12,1,901,39,9,48,0.8125
G1200010000902,12,1,902,0,0,0,
G1200010001000,12,1,1000,0,187,187,0
G1200010001100,12,1,1100,42,424,466,0.090128757
G1200010001201,12,1,1201,0,283,283,0
G1200010001202,12,1,1202,144,418,562,0.25622776
G1200010001203,12,1,1203,43,201,244,0.17622951
G1200010001400,12,1,1400,63,147,210,0.30000001
G1200010001514,12,1,1514,0,17,17,0
G1200010001515,12,1,1515,98,37,135,0.72592592
G1200010001516,12,1,1516,54,15,69,0.78260869
G1200010001517,12,1,1517,0,62,62,0
G1200010001519,12,1,1519,0,97,97,0
G1200010001520,12,1,1520,50,15,65,0.76923078
G1200010001521,12,1,1521,34,51,85,0.40000001
G1200010001603,12,1,1603,5,53,58,0.086206898
G1200010001604,12,1,1604,0,171,171,0
G1200010001701,12,1,1701,43,476,519,0.082851641
G1200010001702,12,1,1702,21,343,364,0.057692308
G1200010001801,12,1,1801,72,593,665,0.10827067
G1200010001802,12,1,1802,117,155,272,0.43014705
G1200010001803,12,1,1803,123,398,521,0.23608445
G1200010001805,12,1,1805,20,107,127,0.15748031
G1200010001806,12,1,1806,170,686,856,0.19859813
G1200010001811,12,1,1811,76,507,583,0.1303602
G1200010001813,12,1,1813,18,400,418,0.043062203
G1200010001814,12,1,1814,0,266,266,0
G1200010001902,12,1,1902,64,166,230,0.27826086
G1200010001907,12,1,1907,84,91,175,0.47999999
G1200010001908,12,1,1908,39,357,396,0.098484851
G1200010002000,12,1,2000,219,476,695,0.31510791
G1200010002101,12,1,2101,53,134,187,0.28342247
G1200010002102,12,1,2102,8,54,62,0.12903225
G1200010002201,12,1,2201,0,383,383,0
G1200010002202,12,1,2202,0,565,565,0
G1200010002204,12,1,2204,0,1358,1358,0
G1200010002205,12,1,2205,102,900,1002,0.1017964
G1200010002207,12,1,2207,0,431,431,0
G1200010002208,12,1,2208,25,244,269,0.092936806
G1200010002209,12,1,2209,64,626,690,0.092753626
G1200010002210,12,1,2210,61,390,451,0.13525499
G1200010002217,12,1,2217,233,187,420,0.55476189
G1200010002218,12,1,2218,84,130,214,0.39252338
G1200010002219,12,1,2219,247,432,679,0.36377025
G1200010002220,12,1,2220,30,102,132,0.22727273
G1200010110800,12,1,110800,0,62,62,0
G1200030040101,12,3,40101,84,596,680,0.12352941
G1200030040102,12,3,40102,181,672,853,0.21219227
G1200030040201,12,3,40201,157,280,437,0.35926774
G1200030040202,12,3,40202,166,463,629,0.26391098
G1200050000201,12,5,201,34,489,523,0.065009557
G1200050000202,12,5,202,97,404,501,0.19361277
G1200050000300,12,5,300,227,448,675,0.33629629
G1200050000400,12,5,400,58,623,681,0.085168868
G1200050000500,12,5,500,67,467,534,0.12546816
G1200050000600,12,5,600,5,30,35,0.14285715
G1200050000700,12,5,700,38,329,367,0.10354223
G1200050000803,12,5,803,127,357,484,0.26239669
G1200050000804,12,5,804,27,164,191,0.14136125
G1200050000805,12,5,805,210,281,491,0.42769858
G1200050000806,12,5,806,114,233,347,0.32853025
G1200050000900,12,5,900,85,199,284,0.29929578
G1200050001000,12,5,1000,101,98,199,0.50753766
G1200050001100,12,5,1100,239,269,508,0.47047246
G1200050001200,12,5,1200,46,220,266,0.17293233
G1200050001301,12,5,1301,60,496,556,0.10791367
G1200050001302,12,5,1302,98,523,621,0.15780999
G1200050001402,12,5,1402,12,659,671,0.017883755
G1200050001403,12,5,1403,74,216,290,0.2551724
G1200050001404,12,5,1404,10,388,398,0.025125628
G1200050001501,12,5,1501,6,424,430,0.013953488
G1200050001502,12,5,1502,44,315,359,0.12256268
G1200050001600,12,5,1600,133,250,383,0.34725848
G1200050001700,12,5,1700,51,215,266,0.19172932
G1200050001800,12,5,1800,61,63,124,0.49193549
G1200050001900,12,5,1900,22,352,374,0.05882353
G1200050002000,12,5,2000,15,52,67,0.2238806
G1200050002200,12,5,2200,130,348,478,0.27196652
G1200050002300,12,5,2300,51,309,360,0.14166667
G1200050002400,12,5,2400,224,272,496,0.45161289
G1200050002500,12,5,2500,50,236,286,0.17482518
G1200050002601,12,5,2601,59,160,219,0.26940638
G1200050002603,12,5,2603,55,137,192,0.28645834
G1200050002604,12,5,2604,57,621,678,0.084070794
G1200050002605,12,5,2605,0,30,30,0
G1200050002606,12,5,2606,4,42,46,0.086956523
G1200050002607,12,5,2607,6,16,22,0.27272728
G1200050002608,12,5,2608,0,159,159,0
G1200050002701,12,5,2701,26,170,196,0.13265306
G1200050002702,12,5,2702,7,84,91,0.07692308
G1200050002703,12,5,2703,59,298,357,0.16526611
G1200050002704,12,5,2704,25,299,324,0.077160493
G1200050002705,12,5,2705,4,102,106,0.03773585
G1200050990000,12,5,990000,0,0,0,
G1200070000100,12,7,100,206,356,562,0.36654803
G1200070000200,12,7,200,170,390,560,0.30357143
G1200070000300,12,7,300,195,564,759,0.256917
G1200070000400,12,7,400,168,271,439,0.38268793
G1200090060101,12,9,60101,159,134,293,0.54266214
G1200090060102,12,9,60102,0,287,287,0
G1200090060200,12,9,60200,13,378,391,0.033248082
G1200090060300,12,9,60300,59,467,526,0.1121673
G1200090060400,12,9,60400,160,157,317,0.50473183
G1200090060500,12,9,60500,132,224,356,0.37078652
G1200090060600,12,9,60600,262,238,500,0.52399999
G1200090060700,12,9,60700,241,74,315,0.76507938
G1200090061001,12,9,61001,45,437,482,0.093360998
G1200090061002,12,9,61002,146,116,262,0.55725193
G1200090061100,12,9,61100,31,381,412,0.075242721
G1200090061201,12,9,61201,0,541,541,0
G1200090061202,12,9,61202,0,205,205,0
G1200090062103,12,9,62103,132,480,612,0.21568628
G1200090062104,12,9,62104,11,463,474,0.023206752
G1200090062106,12,9,62106,131,186,317,0.41324922
G1200090062107,12,9,62107,18,163,181,0.099447511
G1200090062108,12,9,62108,29,661,690,0.042028986
G1200090062109,12,9,62109,169,288,457,0.36980307
G1200090062301,12,9,62301,169,176,345,0.48985508
G1200090062302,12,9,62302,183,167,350,0.52285713
G1200090062400,12,9,62400,281,357,638,0.44043887
G1200090062500,12,9,62500,104,169,273,0.38095239
G1200090062600,12,9,62600,233,164,397,0.58690178
G1200090062800,12,9,62800,44,291,335,0.13134329
G1200090062900,12,9,62900,109,502,611,0.17839608
G1200090063000,12,9,63000,45,329,374,0.12032086
G1200090063102,12,9,63102,70,718,788,0.08883249
G1200090063104,12,9,63104,0,283,283,0
G1200090063105,12,9,63105,0,816,816,0
G1200090063106,12,9,63106,68,318,386,0.1761658
G1200090063107,12,9,63107,11,809,820,0.013414634
G1200090064102,12,9,64102,0,429,429,0
G1200090064123,12,9,64123,0,266,266,0
G1200090064124,12,9,64124,58,272,330,0.17575757
G1200090064125,12,9,64125,30,421,451,0.066518851
G1200090064126,12,9,64126,0,310,310,0
G1200090064127,12,9,64127,73,451,524,0.13931298
G1200090064128,12,9,64128,48,1198,1246,0.038523275
G1200090064201,12,9,64201,87,128,215,0.40465117
G1200090064202,12,9,64202,65,117,182,0.35714287
G1200090064301,12,9,64301,156,528,684,0.22807017
G1200090064302,12,9,64302,35,407,442,0.079185523
G1200090064400,12,9,64400,148,348,496,0.29838711
G1200090064500,12,9,64500,52,351,403,0.12903225
G1200090064601,12,9,64601,29,506,535,0.054205608
G1200090064602,12,9,64602,21,90,111,0.1891892
G1200090064700,12,9,64700,19,199,218,0.087155961
G1200090064800,12,9,64800,28,102,130,0.21538462
G1200090064901,12,9,64901,32,200,232,0.13793103
G1200090064902,12,9,64902,32,100,132,0.24242425
G1200090065001,12,9,65001,0,240,240,0
G1200090065021,12,9,65021,26,901,927,0.028047465
G1200090065022,12,9,65022,93,295,388,0.23969072
G1200090065121,12,9,65121,212,427,639,0.33176839
G1200090065122,12,9,65122,241,354,595,0.40504202
G1200090065123,12,9,65123,56,141,197,0.28426397
G1200090065124,12,9,65124,114,58,172,0.66279072
G1200090065125,12,9,65125,100,178,278,0.35971224
G1200090065201,12,9,65201,116,292,408,0.28431374
G1200090065202,12,9,65202,55,376,431,0.12761021
G1200090065231,12,9,65231,112,403,515,0.21747573
G1200090065234,12,9,65234,11,72,83,0.13253012
G1200090065235,12,9,65235,112,32,144,0.77777779
G1200090065236,12,9,65236,0,91,91,0
G1200090066101,12,9,66101,0,268,268,0
G1200090066103,12,9,66103,6,71,77,0.077922076
G1200090066104,12,9,66104,78,251,329,0.23708206
G1200090066200,12,9,66200,46,205,251,0.18326694
G1200090066301,12,9,66301,163,442,605,0.26942149
G1200090066302,12,9,66302,0,302,302,0
G1200090066400,12,9,66400,148,227,375,0.39466667
G1200090066500,12,9,66500,39,286,325,0.12
G1200090066600,12,9,66600,25,346,371,0.067385443
G1200090066700,12,9,66700,14,340,354,0.039548021
G1200090066800,12,9,66800,30,160,190,0.15789473
G1200090066900,12,9,66900,117,551,668,0.17514969
G1200090067100,12,9,67100,4,132,136,0.029411765
G1200090068101,12,9,68101,6,110,116,0.05172414
G1200090068102,12,9,68102,79,368,447,0.17673378
G1200090068200,12,9,68200,11,185,196,0.056122448
G1200090068300,12,9,68300,0,33,33,0
G1200090068400,12,9,68400,21,39,60,0.34999999
G1200090068501,12,9,68501,11,45,56,0.19642857
G1200090068502,12,9,68502,20,106,126,0.15873016
G1200090068601,12,9,68601,28,63,91,0.30769232
G1200090068602,12,9,68602,19,98,117,0.16239317
G1200090069100,12,9,69100,80,420,500,0.16
G1200090069200,12,9,69200,22,149,171,0.12865497
G1200090069300,12,9,69300,0,193,193,0
G1200090069400,12,9,69400,36,427,463,0.077753782
G1200090069700,12,9,69700,74,89,163,0.45398772
G1200090069801,12,9,69801,70,234,304,0.23026316
G1200090069802,12,9,69802,201,337,538,0.37360594
G1200090069901,12,9,69901,68,711,779,0.087291397
G1200090069902,12,9,69902,104,280,384,0.27083334
G1200090071100,12,9,71100,63,143,206,0.30582523
G1200090071200,12,9,71200,0,1453,1453,0
G1200090071301,12,9,71301,0,326,326,0
G1200090071322,12,9,71322,219,897,1116,0.19623657
G1200090071332,12,9,71332,359,1036,1395,0.25734767
G1200090071334,12,9,71334,46,544,590,0.077966101
G1200090071335,12,9,71335,11,410,421,0.026128266
G1200090071336,12,9,71336,18,469,487,0.036960986
G1200090071337,12,9,71337,293,636,929,0.31539288
G1200090071338,12,9,71338,135,754,889,0.15185602
G1200090071339,12,9,71339,72,553,625,0.1152
G1200090071340,12,9,71340,221,996,1217,0.18159409
G1200090071400,12,9,71400,27,47,74,0.36486486
G1200090071500,12,9,71500,27,117,144,0.1875
G1200090071600,12,9,71600,116,155,271,0.42804429
G1200090980000,12,9,980000,0,0,0,
G1200090980100,12,9,980100,0,0,0,
G1200090990000,12,9,990000,0,0,0,
G1200110010102,12,11,10102,22,164,186,0.11827957
G1200110010103,12,11,10103,44,154,198,0.22222222
G1200110010104,12,11,10104,8,43,51,0.15686275
G1200110010200,12,11,10200,98,406,504,0.19444445
G1200110010304,12,11,10304,157,259,416,0.37740386
G1200110010305,12,11,10305,117,221,338,0.34615386
G1200110010306,12,11,10306,25,192,217,0.11520737
G1200110010307,12,11,10307,95,191,286,0.33216783
G1200110010308,12,11,10308,51,268,319,0.1598746
G1200110010401,12,11,10401,83,452,535,0.15514019
G1200110010402,12,11,10402,51,180,231,0.22077923
G1200110010403,12,11,10403,0,0,0,
G1200110010405,12,11,10405,195,651,846,0.23049645
G1200110010406,12,11,10406,49,398,447,0.10961968
G1200110010407,12,11,10407,39,262,301,0.1295681
G1200110010502,12,11,10502,24,416,440,0.054545455
G1200110010503,12,11,10503,53,1891,1944,0.027263375
G1200110010504,12,11,10504,72,833,905,0.079558007
G1200110010601,12,11,10601,34,1079,1113,0.030548068
G1200110010603,12,11,10603,2,733,735,0.002721089
G1200110010604,12,11,10604,78,508,586,0.1331058
G1200110010605,12,11,10605,12,726,738,0.016260162
G1200110010606,12,11,10606,64,789,853,0.075029306
G1200110010607,12,11,10607,51,1307,1358,0.037555229
G1200110010609,12,11,10609,11,343,354,0.031073445
G1200110010610,12,11,10610,46,568,614,0.074918568
G1200110010611,12,11,10611,45,415,460,0.097826086
G1200110010612,12,11,10612,8,899,907,0.008820287
G1200110010701,12,11,10701,128,402,530,0.24150944
G1200110010702,12,11,10702,214,612,826,0.2590799
G1200110010800,12,11,10800,308,367,675,0.45629629
G1200110010901,12,11,10901,17,119,136,0.125
G1200110010902,12,11,10902,0,143,143,0
G1200110011000,12,11,11000,0,20,20,0
G1200110020101,12,11,20101,12,765,777,0.015444015
G1200110020103,12,11,20103,63,461,524,0.12022901
G1200110020104,12,11,20104,9,118,127,0.070866145
G1200110020204,12,11,20204,43,475,518,0.083011582
G1200110020205,12,11,20205,65,573,638,0.10188088
G1200110020206,12,11,20206,96,291,387,0.24806201
G1200110020207,12,11,20207,0,299,299,0
G1200110020209,12,11,20209,56,235,291,0.19243987
G1200110020210,12,11,20210,70,362,432,0.16203703
G1200110020211,12,11,20211,42,148,190,0.22105263
G1200110020212,12,11,20212,26,85,111,0.23423423
G1200110020302,12,11,20302,203,416,619,0.3279483
G1200110020308,12,11,20308,151,576,727,0.20770289
G1200110020309,12,11,20309,22,547,569,0.038664322
G1200110020311,12,11,20311,73,323,396,0.18434343
G1200110020312,12,11,20312,62,655,717,0.086471409
G1200110020313,12,11,20313,338,586,924,0.36580086
G1200110020314,12,11,20314,70,343,413,0.16949153
G1200110020315,12,11,20315,76,462,538,0.14126395
G1200110020316,12,11,20316,127,434,561,0.22638147
G1200110020317,12,11,20317,45,399,444,0.10135135
G1200110020318,12,11,20318,102,998,1100,0.092727274
G1200110020319,12,11,20319,65,645,710,0.091549292
G1200110020320,12,11,20320,66,425,491,0.13441955
G1200110020321,12,11,20321,0,180,180,0
G1200110020322,12,11,20322,64,270,334,0.19161677
G1200110020323,12,11,20323,68,252,320,0.21250001
G1200110020324,12,11,20324,61,629,690,0.088405795
G1200110020325,12,11,20325,41,411,452,0.090707965
G1200110020326,12,11,20326,245,620,865,0.28323698
G1200110020404,12,11,20404,108,690,798,0.13533835
G1200110020405,12,11,20405,127,395,522,0.24329501
G1200110020406,12,11,20406,225,673,898,0.2505568
G1200110020407,12,11,20407,190,624,814,0.23341523
G1200110020409,12,11,20409,42,320,362,0.1160221
G1200110020411,12,11,20411,32,618,650,0.049230769
G1200110020412,12,11,20412,232,252,484,0.47933885
G1200110020413,12,11,20413,207,693,900,0.23
G1200110020414,12,11,20414,32,361,393,0.081424937
G1200110020415,12,11,20415,53,231,284,0.18661971
G1200110020501,12,11,20501,62,564,626,0.099041536
G1200110020502,12,11,20502,229,674,903,0.25359911
G1200110030100,12,11,30100,10,314,324,0.030864198
G1200110030201,12,11,30201,198,238,436,0.45412844
G1200110030202,12,11,30202,19,125,144,0.13194445
G1200110030203,12,11,30203,153,295,448,0.34151787
G1200110030301,12,11,30301,164,52,216,0.75925928
G1200110030302,12,11,30302,144,407,551,0.261343
G1200110030401,12,11,30401,98,254,352,0.27840909
G1200110030402,12,11,30402,242,186,428,0.56542057
G1200110030500,12,11,30500,223,232,455,0.49010989
G1200110030600,12,11,30600,161,359,520,0.30961537
G1200110030702,12,11,30702,0,334,334,0
G1200110030703,12,11,30703,43,413,456,0.094298244
G1200110030704,12,11,30704,18,213,231,0.077922076
G1200110030705,12,11,30705,0,0,0,
G1200110030801,12,11,30801,437,305,742,0.58894879
G1200110030802,12,11,30802,0,231,231,0
G1200110030902,12,11,30902,51,159,210,0.24285714
G1200110030903,12,11,30903,287,149,436,0.65825689
G1200110030904,12,11,30904,37,440,477,0.077568136
G1200110031001,12,11,31001,45,105,150,0.30000001
G1200110031002,12,11,31002,134,299,433,0.30946884
G1200110031101,12,11,31101,39,150,189,0.20634921
G1200110031102,12,11,31102,27,121,148,0.18243243
G1200110031202,12,11,31202,0,172,172,0
G1200110031203,12,11,31203,0,18,18,0
G1200110031204,12,11,31204,7,0,7,1
G1200110031205,12,11,31205,0,80,80,0
G1200110040101,12,11,40101,0,58,58,0
G1200110040102,12,11,40102,8,140,148,0.054054055
G1200110040203,12,11,40203,0,73,73,0
G1200110040204,12,11,40204,0,87,87,0
G1200110040205,12,11,40205,0,318,318,0
G1200110040206,12,11,40206,18,204,222,0.081081077
G1200110040300,12,11,40300,41,206,247,0.1659919
G1200110040401,12,11,40401,11,86,97,0.11340206
G1200110040402,12,11,40402,55,156,211,0.26066351
G1200110040502,12,11,40502,0,174,174,0
G1200110040503,12,11,40503,0,48,48,0
G1200110040504,12,11,40504,0,13,13,0
G1200110040601,12,11,40601,45,144,189,0.23809524
G1200110040602,12,11,40602,0,197,197,0
G1200110040701,12,11,40701,0,120,120,0
G1200110040702,12,11,40702,35,197,232,0.15086207
G1200110040801,12,11,40801,205,179,384,0.53385419
G1200110040802,12,11,40802,152,159,311,0.48874599
G1200110040901,12,11,40901,223,279,502,0.44422311
G1200110040902,12,11,40902,131,290,421,0.3111639
G1200110041000,12,11,41000,112,166,278,0.40287769
G1200110041100,12,11,41100,165,405,570,0.28947368
G1200110041200,12,11,41200,203,248,451,0.45011085
G1200110041300,12,11,41300,299,475,774,0.38630491
G1200110041400,12,11,41400,254,142,396,0.64141417
G1200110041500,12,11,41500,254,194,448,0.56696427
G1200110041600,12,11,41600,258,401,659,0.39150229
G1200110041700,12,11,41700,259,148,407,0.63636363
G1200110041801,12,11,41801,20,65,85,0.23529412
G1200110041802,12,11,41802,13,131,144,0.090277776
G1200110041900,12,11,41900,0,111,111,0
G1200110042000,12,11,42000,8,146,154,0.051948052
G1200110042100,12,11,42100,0,95,95,0
G1200110042200,12,11,42200,0,152,152,0
G1200110042301,12,11,42301,0,148,148,0
G1200110042302,12,11,42302,0,63,63,0
G1200110042400,12,11,42400,0,134,134,0
G1200110042500,12,11,42500,0,164,164,0
G1200110042600,12,11,42600,13,102,115,0.11304348
G1200110042700,12,11,42700,249,267,516,0.48255813
G1200110042800,12,11,42800,314,499,813,0.38622385
G1200110042900,12,11,42900,237,512,749,0.3164219
G1200110043001,12,11,43001,0,53,53,0
G1200110043002,12,11,43002,150,621,771,0.19455253
G1200110043100,12,11,43100,133,342,475,0.28
G1200110043301,12,11,43301,160,338,498,0.32128513
G1200110043302,12,11,43302,80,135,215,0.37209302
G1200110050100,12,11,50100,50,383,433,0.11547344
G1200110050204,12,11,50204,156,280,436,0.35779816
G1200110050205,12,11,50205,22,128,150,0.14666666
G1200110050206,12,11,50206,62,216,278,0.22302158
G1200110050207,12,11,50207,75,575,650,0.11538462
G1200110050208,12,11,50208,169,359,528,0.32007575
G1200110050301,12,11,50301,333,657,990,0.33636364
G1200110050306,12,11,50306,153,333,486,0.31481481
G1200110050307,12,11,50307,171,406,577,0.29636049
G1200110050308,12,11,50308,122,213,335,0.3641791
G1200110050309,12,11,50309,49,239,288,0.1701389
G1200110050310,12,11,50310,0,418,418,0
G1200110050311,12,11,50311,107,181,288,0.37152779
G1200110050312,12,11,50312,34,156,190,0.17894737
G1200110050401,12,11,50401,29,191,220,0.13181818
G1200110050402,12,11,50402,25,138,163,0.15337424
G1200110050501,12,11,50501,93,238,331,0.28096676
G1200110050502,12,11,50502,91,316,407,0.22358723
G1200110050601,12,11,50601,51,115,166,0.30722892
G1200110050602,12,11,50602,122,78,200,0.61000001
G1200110050701,12,11,50701,140,163,303,0.46204621
G1200110050702,12,11,50702,165,338,503,0.32803181
G1200110050800,12,11,50800,201,291,492,0.40853658
G1200110050900,12,11,50900,32,274,306,0.10457516
G1200110051001,12,11,51001,0,130,130,0
G1200110051002,12,11,51002,6,57,63,0.095238097
G1200110060105,12,11,60105,174,546,720,0.24166666
G1200110060107,12,11,60107,22,206,228,0.096491225
G1200110060109,12,11,60109,0,182,182,0
G1200110060111,12,11,60111,51,689,740,0.068918921
G1200110060112,12,11,60112,31,239,270,0.11481482
G1200110060113,12,11,60113,157,585,742,0.21159029
G1200110060114,12,11,60114,98,589,687,0.1426492
G1200110060115,12,11,60115,20,716,736,0.027173912
G1200110060116,12,11,60116,74,829,903,0.081949055
G1200110060117,12,11,60117,209,743,952,0.21953781
G1200110060118,12,11,60118,26,516,542,0.047970481
G1200110060119,12,11,60119,12,394,406,0.029556651
G1200110060120,12,11,60120,34,656,690,0.049275361
G1200110060121,12,11,60121,14,595,609,0.022988506
G1200110060122,12,11,60122,108,391,499,0.21643287
G1200110060123,12,11,60123,60,227,287,0.20905924
G1200110060124,12,11,60124,98,277,375,0.26133335
G1200110060125,12,11,60125,55,239,294,0.18707483
G1200110060126,12,11,60126,90,467,557,0.16157989
G1200110060127,12,11,60127,149,110,259,0.57528955
G1200110060128,12,11,60128,139,541,680,0.20441176
G1200110060203,12,11,60203,210,353,563,0.37300178
G1200110060206,12,11,60206,88,209,297,0.2962963
G1200110060207,12,11,60207,24,136,160,0.15000001
G1200110060208,12,11,60208,134,437,571,0.234676
G1200110060209,12,11,60209,44,217,261,0.16858238
G1200110060210,12,11,60210,33,294,327,0.10091743
G1200110060211,12,11,60211,0,83,83,0
G1200110060212,12,11,60212,0,265,265,0
G1200110060213,12,11,60213,0,93,93,0
G1200110060302,12,11,60302,315,325,640,0.4921875
G1200110060303,12,11,60303,100,555,655,0.15267175
G1200110060304,12,11,60304,171,204,375,0.456
G1200110060305,12,11,60305,99,179,278,0.3561151
G1200110060306,12,11,60306,30,31,61,0.49180329
G1200110060401,12,11,60401,87,302,389,0.22365038
G1200110060402,12,11,60402,107,630,737,0.14518318
G1200110060403,12,11,60403,13,283,296,0.043918919
G1200110060501,12,11,60501,259,479,738,0.35094851
G1200110060503,12,11,60503,28,458,486,0.057613168
G1200110060504,12,11,60504,22,344,366,0.060109291
G1200110060505,12,11,60505,0,161,161,0
G1200110060603,12,11,60603,0,453,453,0
G1200110060605,12,11,60605,23,303,326,0.070552148
G1200110060606,12,11,60606,24,420,444,0.054054055
G1200110060607,12,11,60607,18,250,268,0.067164183
G1200110060608,12,11,60608,74,462,536,0.13805971
G1200110060609,12,11,60609,60,230,290,0.20689656
G1200110060700,12,11,60700,11,250,261,0.042145595
G1200110060801,12,11,60801,23,215,238,0.096638657
G1200110060802,12,11,60802,195,475,670,0.29104477
G1200110060900,12,11,60900,23,423,446,0.051569507
G1200110061001,12,11,61001,13,547,560,0.023214286
G1200110061002,12,11,61002,55,755,810,0.067901231
G1200110061100,12,11,61100,128,561,689,0.18577649
G1200110070101,12,11,70101,176,557,733,0.24010915
G1200110070102,12,11,70102,0,148,148,0
G1200110070204,12,11,70204,61,143,204,0.2990196
G1200110070205,12,11,70205,67,554,621,0.1078905
G1200110070207,12,11,70207,45,326,371,0.1212938
G1200110070208,12,11,70208,167,1076,1243,0.13435237
G1200110070209,12,11,70209,0,632,632,0
G1200110070210,12,11,70210,36,230,266,0.13533835
G1200110070211,12,11,70211,0,553,553,0
G1200110070304,12,11,70304,32,875,907,0.035281148
G1200110070305,12,11,70305,41,763,804,0.050995026
G1200110070306,12,11,70306,42,906,948,0.044303797
G1200110070310,12,11,70310,38,277,315,0.12063492
G1200110070311,12,11,70311,104,795,899,0.11568409
G1200110070312,12,11,70312,45,939,984,0.045731708
G1200110070313,12,11,70313,49,1525,1574,0.031130876
G1200110070314,12,11,70314,37,447,484,0.07644628
G1200110070315,12,11,70315,5,663,668,0.00748503
G1200110070316,12,11,70316,38,546,584,0.065068491
G1200110070317,12,11,70317,210,2434,2644,0.079425111
G1200110070318,12,11,70318,13,877,890,0.014606741
G1200110070319,12,11,70319,39,694,733,0.053206004
G1200110070320,12,11,70320,92,1081,1173,0.078431375
G1200110070321,12,11,70321,35,146,181,0.19337016
G1200110070322,12,11,70322,30,718,748,0.040106952
G1200110070401,12,11,70401,49,692,741,0.066126853
G1200110070402,12,11,70402,27,431,458,0.058951966
G1200110070403,12,11,70403,85,605,690,0.12318841
G1200110070404,12,11,70404,28,328,356,0.078651689
G1200110070405,12,11,70405,0,652,652,0
G1200110070501,12,11,70501,4,647,651,0.006144393
G1200110070502,12,11,70502,198,1053,1251,0.15827338
G1200110070601,12,11,70601,75,400,475,0.15789473
G1200110070602,12,11,70602,70,357,427,0.16393442
G1200110080101,12,11,80101,0,167,167,0
G1200110080102,12,11,80102,205,214,419,0.48926014
G1200110080103,12,11,80103,0,53,53,0
G1200110080200,12,11,80200,0,79,79,0
G1200110080402,12,11,80402,24,112,136,0.17647059
G1200110080403,12,11,80403,183,495,678,0.2699115
G1200110080405,12,11,80405,40,167,207,0.19323671
G1200110080406,12,11,80406,41,447,488,0.08401639
G1200110080500,12,11,80500,581,399,980,0.59285712
G1200110090101,12,11,90101,0,214,214,0
G1200110090102,12,11,90102,0,0,0,
G1200110090200,12,11,90200,33,324,357,0.092436977
G1200110090301,12,11,90301,43,54,97,0.44329897
G1200110090302,12,11,90302,158,472,630,0.25079367
G1200110090401,12,11,90401,51,270,321,0.15887851
G1200110090403,12,11,90403,51,230,281,0.18149467
G1200110090404,12,11,90404,163,384,547,0.29798904
G1200110090502,12,11,90502,81,541,622,0.13022508
G1200110090503,12,11,90503,47,211,258,0.18217054
G1200110090504,12,11,90504,43,161,204,0.21078432
G1200110090601,12,11,90601,38,238,276,0.13768116
G1200110090602,12,11,90602,73,320,393,0.18575063
G1200110090700,12,11,90700,160,806,966,0.16563147
G1200110090801,12,11,90801,54,365,419,0.12887828
G1200110090802,12,11,90802,83,316,399,0.20802005
G1200110090900,12,11,90900,5,526,531,0.009416196
G1200110091000,12,11,91000,0,382,382,0
G1200110091100,12,11,91100,351,385,736,0.47690219
G1200110091201,12,11,91201,158,309,467,0.33832976
G1200110091202,12,11,91202,53,371,424,0.125
G1200110091300,12,11,91300,32,316,348,0.091954023
G1200110091400,12,11,91400,85,521,606,0.14026402
G1200110091500,12,11,91500,116,466,582,0.19931272
G1200110091600,12,11,91600,0,325,325,0
G1200110091701,12,11,91701,92,218,310,0.29677418
G1200110091702,12,11,91702,150,158,308,0.48701298
G1200110091801,12,11,91801,154,386,540,0.28518519
G1200110091802,12,11,91802,168,286,454,0.37004405
G1200110091901,12,11,91901,63,278,341,0.18475074
G1200110091902,12,11,91902,129,375,504,0.25595239
G1200110092000,12,11,92000,11,386,397,0.027707808
G1200110100101,12,11,100101,122,256,378,0.32275131
G1200110100103,12,11,100103,84,170,254,0.33070865
G1200110100104,12,11,100104,51,28,79,0.64556962
G1200110100105,12,11,100105,0,73,73,0
G1200110100201,12,11,100201,32,58,90,0.35555556
G1200110100202,12,11,100202,199,186,385,0.51688313
G1200110100300,12,11,100300,263,327,590,0.44576272
G1200110100400,12,11,100400,160,341,501,0.31936127
G1200110100501,12,11,100501,0,45,45,0
G1200110100502,12,11,100502,266,100,366,0.72677594
G1200110100600,12,11,100600,111,383,494,0.22469635
G1200110100700,12,11,100700,229,342,571,0.40105078
G1200110100801,12,11,100801,118,263,381,0.30971128
G1200110100802,12,11,100802,166,822,988,0.1680162
G1200110110100,12,11,110100,158,473,631,0.25039619
G1200110110301,12,11,110301,0,912,912,0
G1200110110302,12,11,110302,110,930,1040,0.10576923
G1200110110303,12,11,110303,23,451,474,0.048523206
G1200110110307,12,11,110307,0,340,340,0
G1200110110308,12,11,110308,206,467,673,0.30609211
G1200110110309,12,11,110309,47,609,656,0.07164634
G1200110110311,12,11,110311,72,602,674,0.10682493
G1200110110312,12,11,110312,89,641,730,0.12191781
G1200110110313,12,11,110313,91,535,626,0.14536741
G1200110110319,12,11,110319,29,538,567,0.051146384
G1200110110320,12,11,110320,271,1221,1492,0.18163539
G1200110110321,12,11,110321,54,705,759,0.071146242
G1200110110322,12,11,110322,62,1100,1162,0.053356282
G1200110110323,12,11,110323,133,650,783,0.16985951
G1200110110324,12,11,110324,51,2351,2402,0.021232307
G1200110110325,12,11,110325,92,3141,3233,0.028456543
G1200110110326,12,11,110326,61,586,647,0.094281301
G1200110110327,12,11,110327,144,821,965,0.14922279
G1200110110328,12,11,110328,43,608,651,0.066052228
G1200110110330,12,11,110330,10,310,320,0.03125
G1200110110331,12,11,110331,92,1295,1387,0.066330209
G1200110110332,12,11,110332,10,559,569,0.017574692
G1200110110333,12,11,110333,0,821,821,0
G1200110110334,12,11,110334,0,54,54,0
G1200110110335,12,11,110335,0,0,0,
G1200110110336,12,11,110336,69,741,810,0.085185185
G1200110110337,12,11,110337,64,562,626,0.10223642
G1200110110338,12,11,110338,0,411,411,0
G1200110110339,12,11,110339,18,225,243,0.074074075
G1200110110340,12,11,110340,32,375,407,0.078624077
G1200110110341,12,11,110341,6,255,261,0.022988506
G1200110110342,12,11,110342,17,1019,1036,0.016409267
G1200110110343,12,11,110343,186,918,1104,0.16847827
G1200110110402,12,11,110402,100,428,528,0.18939394
G1200110110403,12,11,110403,124,602,726,0.1707989
G1200110110404,12,11,110404,175,621,796,0.21984924
G1200110110501,12,11,110501,99,280,379,0.26121372
G1200110110502,12,11,110502,166,459,625,0.2656
G1200110110600,12,11,110600,58,159,217,0.26728112
G1200110980000,12,11,980000,0,0,0,
G1200110990000,12,11,990000,0,0,0,
G1200130010100,12,13,10100,56,257,313,0.17891374
G1200130010200,12,13,10200,9,385,394,0.02284264
G1200130010300,12,13,10300,203,610,813,0.2496925
G1200150010100,12,15,10100,51,171,222,0.22972973
G1200150010200,12,15,10200,50,232,282,0.17730497
G1200150010301,12,15,10301,0,63,63,0
G1200150010302,12,15,10302,87,91,178,0.48876405
G1200150010401,12,15,10401,0,68,68,0
G1200150010402,12,15,10402,107,84,191,0.56020945
G1200150010403,12,15,10403,0,46,46,0
G1200150010404,12,15,10404,0,130,130,0
G1200150010501,12,15,10501,54,371,425,0.12705882
G1200150010502,12,15,10502,0,284,284,0
G1200150020101,12,15,20101,161,553,714,0.2254902
G1200150020103,12,15,20103,74,404,478,0.15481171
G1200150020104,12,15,20104,0,33,33,0
G1200150020201,12,15,20201,70,593,663,0.10558069
G1200150020202,12,15,20202,94,244,338,0.27810651
G1200150020301,12,15,20301,28,341,369,0.075880758
G1200150020302,12,15,20302,70,223,293,0.23890784
G1200150020303,12,15,20303,27,337,364,0.074175827
G1200150020400,12,15,20400,74,388,462,0.16017316
G1200150020501,12,15,20501,0,315,315,0
G1200150020502,12,15,20502,10,102,112,0.089285716
G1200150020601,12,15,20601,46,88,134,0.34328359
G1200150020602,12,15,20602,166,116,282,0.58865249
G1200150020700,12,15,20700,143,173,316,0.45253164
G1200150020800,12,15,20800,153,262,415,0.3686747
G1200150020900,12,15,20900,132,405,537,0.24581006
G1200150021001,12,15,21001,42,111,153,0.27450982
G1200150021002,12,15,21002,18,104,122,0.14754099
G1200150021003,12,15,21003,62,122,184,0.33695653
G1200150030100,12,15,30100,97,211,308,0.31493506
G1200150030200,12,15,30200,25,433,458,0.054585151
G1200150030301,12,15,30301,7,149,156,0.044871796
G1200150030302,12,15,30302,70,64,134,0.52238804
G1200150030401,12,15,30401,60,58,118,0.50847459
G1200150030402,12,15,30402,8,53,61,0.13114753
G1200150030501,12,15,30501,7,133,140,0.050000001
G1200150030502,12,15,30502,0,260,260,0
G1200150030503,12,15,30503,0,315,315,0
G1200150990000,12,15,990000,0,0,0,
G1200170450101,12,17,450101,145,254,399,0.36340854
G1200170450102,12,17,450102,71,128,199,0.35678393
G1200170450201,12,17,450201,29,144,173,0.16763006
G1200170450202,12,17,450202,183,206,389,0.47043702
G1200170450302,12,17,450302,177,686,863,0.20509849
G1200170450303,12,17,450303,109,249,358,0.30446929
G1200170450304,12,17,450304,67,729,796,0.084170856
G1200170450400,12,17,450400,106,284,390,0.27179489
G1200170450500,12,17,450500,53,104,157,0.33757961
G1200170450601,12,17,450601,47,216,263,0.17870723
G1200170450602,12,17,450602,0,262,262,0
G1200170450701,12,17,450701,131,174,305,0.42950821
G1200170450702,12,17,450702,218,543,761,0.28646517
G1200170450800,12,17,450800,85,216,301,0.28239202
G1200170450901,12,17,450901,35,133,168,0.20833333
G1200170450902,12,17,450902,35,133,168,0.20833333
G1200170451000,12,17,451000,99,345,444,0.22297297
G1200170451101,12,17,451101,15,186,201,0.074626863
G1200170451102,12,17,451102,150,262,412,0.36407766
G1200170451200,12,17,451200,24,156,180,0.13333334
G1200170451300,12,17,451300,20,263,283,0.07067138
G1200170451400,12,17,451400,68,233,301,0.22591361
G1200170451501,12,17,451501,63,144,207,0.30434781
G1200170451502,12,17,451502,320,169,489,0.65439671
G1200170451601,12,17,451601,0,206,206,0
G1200170451602,12,17,451602,82,218,300,0.27333334
G1200170451700,12,17,451700,63,87,150,0.41999999
G1200170990000,12,17,990000,0,0,0,
G1200190030102,12,19,30102,260,545,805,0.32298136
G1200190030103,12,19,30103,58,386,444,0.13063063
G1200190030104,12,19,30104,84,230,314,0.26751593
G1200190030201,12,19,30201,100,1908,2008,0.049800798
G1200190030202,12,19,30202,245,984,1229,0.19934906
G1200190030203,12,19,30203,212,2569,2781,0.076231569
G1200190030301,12,19,30301,78,777,855,0.091228068
G1200190030303,12,19,30303,7,174,181,0.038674034
G1200190030304,12,19,30304,48,354,402,0.11940298
G1200190030400,12,19,30400,91,156,247,0.36842105
G1200190030500,12,19,30500,42,191,233,0.18025751
G1200190030600,12,19,30600,24,401,425,0.056470588
G1200190030701,12,19,30701,0,742,742,0
G1200190030702,12,19,30702,114,1996,2110,0.054028437
G1200190030703,12,19,30703,20,1384,1404,0.014245015
G1200190030801,12,19,30801,40,501,541,0.073937155
G1200190030802,12,19,30802,107,609,716,0.14944135
G1200190030902,12,19,30902,173,1054,1227,0.1409943
G1200190030903,12,19,30903,133,223,356,0.37359551
G1200190030904,12,19,30904,0,585,585,0
G1200190031101,12,19,31101,29,233,262,0.11068702
G1200190031104,12,19,31104,18,383,401,0.044887781
G1200190031105,12,19,31105,76,141,217,0.35023043
G1200190031106,12,19,31106,169,449,618,0.27346277
G1200190031107,12,19,31107,0,25,25,0
G1200190031108,12,19,31108,25,67,92,0.27173913
G1200190031200,12,19,31200,193,1446,1639,0.11775473
G1200190031300,12,19,31300,14,464,478,0.029288704
G1200190031400,12,19,31400,111,355,466,0.23819743
G1200190031500,12,19,31500,90,211,301,0.29900333
G1200210000101,12,21,101,0,32,32,0
G1200210000102,12,21,102,0,33,33,0
G1200210000200,12,21,200,25,165,190,0.13157895
G1200210000301,12,21,301,0,84,84,0
G1200210000302,12,21,302,22,56,78,0.2820513
G1200210000401,12,21,401,0,16,16,0
G1200210000402,12,21,402,0,0,0,
G1200210000500,12,21,500,18,72,90,0.2
G1200210000600,12,21,600,14,82,96,0.14583333
G1200210000700,12,21,700,78,77,155,0.5032258
G1200210010102,12,21,10102,0,329,329,0
G1200210010105,12,21,10105,12,71,83,0.14457831
G1200210010106,12,21,10106,0,58,58,0
G1200210010107,12,21,10107,41,332,373,0.10991957
G1200210010108,12,21,10108,14,151,165,0.084848486
G1200210010109,12,21,10109,58,153,211,0.27488151
G1200210010110,12,21,10110,81,333,414,0.19565217
G1200210010205,12,21,10205,0,172,172,0
G1200210010208,12,21,10208,0,21,21,0
G1200210010209,12,21,10209,9,54,63,0.14285715
G1200210010210,12,21,10210,6,209,215,0.027906977
G1200210010211,12,21,10211,18,25,43,0.41860464
G1200210010212,12,21,10212,94,466,560,0.16785714
G1200210010213,12,21,10213,20,150,170,0.11764706
G1200210010215,12,21,10215,0,17,17,0
G1200210010300,12,21,10300,56,319,375,0.14933333
G1200210010401,12,21,10401,189,304,493,0.38336715
G1200210010405,12,21,10405,87,1244,1331,0.065364391
G1200210010408,12,21,10408,35,291,326,0.10736196
G1200210010410,12,21,10410,569,627,1196,0.4757525
G1200210010411,12,21,10411,376,560,936,0.40170941
G1200210010412,12,21,10412,92,702,794,0.11586902
G1200210010413,12,21,10413,119,649,768,0.15494792
G1200210010414,12,21,10414,0,516,516,0
G1200210010415,12,21,10415,152,1353,1505,0.10099668
G1200210010416,12,21,10416,0,240,240,0
G1200210010417,12,21,10417,45,298,343,0.13119534
G1200210010418,12,21,10418,0,401,401,0
G1200210010419,12,21,10419,211,253,464,0.45474139
G1200210010420,12,21,10420,286,462,748,0.38235295
G1200210010505,12,21,10505,198,595,793,0.24968474
G1200210010506,12,21,10506,89,138,227,0.39207047
G1200210010507,12,21,10507,164,208,372,0.44086021
G1200210010508,12,21,10508,83,194,277,0.29963899
G1200210010509,12,21,10509,20,57,77,0.25974026
G1200210010510,12,21,10510,0,11,11,0
G1200210010601,12,21,10601,78,126,204,0.38235295
G1200210010602,12,21,10602,48,184,232,0.20689656
G1200210010604,12,21,10604,0,69,69,0
G1200210010605,12,21,10605,28,205,233,0.12017167
G1200210010606,12,21,10606,0,96,96,0
G1200210010701,12,21,10701,39,168,207,0.1884058
G1200210010702,12,21,10702,44,219,263,0.16730037
G1200210010801,12,21,10801,9,168,177,0.050847456
G1200210010802,12,21,10802,322,620,942,0.3418259
G1200210010803,12,21,10803,22,215,237,0.092827007
G1200210010902,12,21,10902,16,231,247,0.06477733
G1200210010903,12,21,10903,60,265,325,0.18461539
G1200210010904,12,21,10904,0,30,30,0
G1200210010905,12,21,10905,0,43,43,0
G1200210011001,12,21,11001,10,23,33,0.30303031
G1200210011002,12,21,11002,0,0,0,
G1200210011102,12,21,11102,227,246,473,0.47991544
G1200210011103,12,21,11103,62,94,156,0.3974359
G1200210011105,12,21,11105,54,73,127,0.42519686
G1200210011106,12,21,11106,73,124,197,0.37055838
G1200210011201,12,21,11201,128,449,577,0.22183709
G1200210011202,12,21,11202,66,2003,2069,0.031899467
G1200210011204,12,21,11204,170,135,305,0.55737704
G1200210011205,12,21,11205,171,33,204,0.83823532
G1200210011301,12,21,11301,306,486,792,0.38636363
G1200210011302,12,21,11302,245,403,648,0.37808642
G1200210011400,12,21,11400,103,301,404,0.25495049
G1200210990000,12,21,990000,0,0,0,
G1200230110201,12,23,110201,79,323,402,0.19651741
G1200230110202,12,23,110202,253,225,478,0.52928871
G1200230110300,12,23,110300,172,327,499,0.34468937
G1200230110400,12,23,110400,69,142,211,0.32701421
G1200230110500,12,23,110500,75,505,580,0.12931034
G1200230110601,12,23,110601,291,493,784,0.37117347
G1200230110602,12,23,110602,51,346,397,0.12846348
G1200230110700,12,23,110700,21,386,407,0.051597051
G1200230110800,12,23,110800,144,440,584,0.24657534
G1200230110901,12,23,110901,142,410,552,0.25724638
G1200230110903,12,23,110903,154,218,372,0.41397849
G1200230110904,12,23,110904,61,367,428,0.14252336
G1200270010101,12,27,10101,179,131,310,0.57741934
G1200270010102,12,27,10102,83,143,226,0.36725664
G1200270010200,12,27,10200,247,366,613,0.40293637
G1200270010301,12,27,10301,279,449,728,0.38324177
G1200270010302,12,27,10302,138,98,236,0.58474576
G1200270010403,12,27,10403,21,165,186,0.11290322
G1200270010404,12,27,10404,50,254,304,0.16447368
G1200270010405,12,27,10405,0,117,117,0
G1200270010406,12,27,10406,54,281,335,0.16119403
G1200290970101,12,29,970101,117,305,422,0.27725118
G1200290970102,12,29,970102,97,332,429,0.22610722
G1200290970200,12,29,970200,35,286,321,0.10903427
G1200290990000,12,29,990000,0,0,0,
G1200310000100,12,31,100,96,280,376,0.25531915
G1200310000200,12,31,200,130,173,303,0.42904291
G1200310000300,12,31,300,96,92,188,0.5106383
G1200310000600,12,31,600,200,240,440,0.45454547
G1200310000700,12,31,700,29,361,390,0.074358977
G1200310000800,12,31,800,23,63,86,0.26744187
G1200310001000,12,31,1000,16,0,16,1
G1200310001100,12,31,1100,61,67,128,0.4765625
G1200310001200,12,31,1200,86,94,180,0.47777778
G1200310001300,12,31,1300,215,150,365,0.58904111
G1200310001400,12,31,1400,266,268,534,0.49812734
G1200310001500,12,31,1500,128,150,278,0.46043167
G1200310001600,12,31,1600,97,51,148,0.6554054
G1200310002101,12,31,2101,11,117,128,0.0859375
G1200310002102,12,31,2102,21,137,158,0.1329114
G1200310002200,12,31,2200,98,149,247,0.39676112
G1200310002300,12,31,2300,8,113,121,0.0661157
G1200310002400,12,31,2400,0,125,125,0
G1200310002501,12,31,2501,112,252,364,0.30769232
G1200310002502,12,31,2502,41,238,279,0.1469534
G1200310002600,12,31,2600,211,69,280,0.75357145
G1200310002701,12,31,2701,170,336,506,0.33596838
G1200310002702,12,31,2702,153,180,333,0.45945945
G1200310002801,12,31,2801,184,167,351,0.52421653
G1200310002802,12,31,2802,206,167,373,0.55227882
G1200310002901,12,31,2901,269,116,385,0.69870132
G1200310002902,12,31,2902,79,112,191,0.41361257
G1200310010101,12,31,10101,13,488,501,0.025948104
G1200310010102,12,31,10102,122,927,1049,0.11630124
G1200310010103,12,31,10103,15,475,490,0.030612245
G1200310010201,12,31,10201,236,957,1193,0.19782062
G1200310010202,12,31,10202,24,335,359,0.066852368
G1200310010301,12,31,10301,41,239,280,0.14642857
G1200310010303,12,31,10303,88,557,645,0.13643411
G1200310010304,12,31,10304,183,658,841,0.2175981
G1200310010401,12,31,10401,108,217,325,0.3323077
G1200310010402,12,31,10402,269,282,551,0.48820326
G1200310010500,12,31,10500,370,1421,1791,0.20658849
G1200310010600,12,31,10600,98,453,551,0.17785844
G1200310010700,12,31,10700,221,315,536,0.41231343
G1200310010800,12,31,10800,176,425,601,0.29284525
G1200310010900,12,31,10900,35,306,341,0.1026393
G1200310011000,12,31,11000,156,155,311,0.50160772
G1200310011100,12,31,11100,148,188,336,0.44047618
G1200310011200,12,31,11200,16,110,126,0.12698413
G1200310011300,12,31,11300,123,122,245,0.5020408
G1200310011400,12,31,11400,64,127,191,0.33507854
G1200310011500,12,31,11500,212,167,379,0.55936676
G1200310011600,12,31,11600,248,133,381,0.65091866
G1200310011700,12,31,11700,63,245,308,0.20454545
G1200310011800,12,31,11800,106,190,296,0.3581081
G1200310011901,12,31,11901,103,711,814,0.12653562
G1200310011902,12,31,11902,373,1039,1412,0.2641643
G1200310011903,12,31,11903,20,350,370,0.054054055
G1200310012000,12,31,12000,98,475,573,0.17102967
G1200310012100,12,31,12100,88,87,175,0.50285715
G1200310012200,12,31,12200,542,343,885,0.61242938
G1200310012300,12,31,12300,91,212,303,0.30033004
G1200310012400,12,31,12400,14,258,272,0.051470589
G1200310012500,12,31,12500,210,223,433,0.48498845
G1200310012601,12,31,12601,156,161,317,0.49211356
G1200310012602,12,31,12602,96,483,579,0.1658031
G1200310012702,12,31,12702,194,326,520,0.37307692
G1200310012703,12,31,12703,166,331,497,0.33400401
G1200310012704,12,31,12704,106,495,601,0.17637271
G1200310012800,12,31,12800,230,462,692,0.33236995
G1200310012900,12,31,12900,50,265,315,0.15873016
G1200310013000,12,31,13000,59,206,265,0.22264151
G1200310013100,12,31,13100,0,197,197,0
G1200310013200,12,31,13200,73,125,198,0.36868685
G1200310013300,12,31,13300,157,471,628,0.25
G1200310013402,12,31,13402,275,292,567,0.48500881
G1200310013403,12,31,13403,82,123,205,0.40000001
G1200310013404,12,31,13404,192,91,283,0.67844522
G1200310013502,12,31,13502,58,312,370,0.15675676
G1200310013503,12,31,13503,329,862,1191,0.27623844
G1200310013504,12,31,13504,207,304,511,0.40508807
G1200310013521,12,31,13521,467,614,1081,0.4320074
G1200310013522,12,31,13522,113,334,447,0.25279641
G1200310013721,12,31,13721,356,929,1285,0.27704281
G1200310013723,12,31,13723,204,620,824,0.24757281
G1200310013726,12,31,13726,221,759,980,0.22551021
G1200310013727,12,31,13727,58,799,857,0.067677945
G1200310013800,12,31,13800,23,191,214,0.10747664
G1200310013901,12,31,13901,85,299,384,0.22135417
G1200310013902,12,31,13902,106,283,389,0.27249357
G1200310013904,12,31,13904,51,296,347,0.14697406
G1200310013905,12,31,13905,10,284,294,0.034013607
G1200310013906,12,31,13906,8,389,397,0.020151133
G1200310014001,12,31,14001,0,181,181,0
G1200310014002,12,31,14002,6,240,246,0.024390243
G1200310014101,12,31,14101,46,244,290,0.15862069
G1200310014102,12,31,14102,38,256,294,0.1292517
G1200310014202,12,31,14202,81,217,298,0.27181208
G1200310014203,12,31,14203,0,366,366,0
G1200310014204,12,31,14204,116,364,480,0.24166666
G1200310014311,12,31,14311,303,340,643,0.47122863
G1200310014312,12,31,14312,70,550,620,0.11290322
G1200310014326,12,31,14326,0,671,671,0
G1200310014328,12,31,14328,90,549,639,0.14084508
G1200310014329,12,31,14329,13,274,287,0.045296166
G1200310014330,12,31,14330,22,310,332,0.066265061
G1200310014331,12,31,14331,67,560,627,0.10685805
G1200310014332,12,31,14332,40,595,635,0.062992126
G1200310014333,12,31,14333,9,237,246,0.036585364
G1200310014334,12,31,14334,68,398,466,0.14592275
G1200310014335,12,31,14335,27,730,757,0.035667107
G1200310014336,12,31,14336,30,666,696,0.043103449
G1200310014337,12,31,14337,189,751,940,0.20106383
G1200310014338,12,31,14338,53,414,467,0.11349037
G1200310014401,12,31,14401,183,605,788,0.23223351
G1200310014404,12,31,14404,39,421,460,0.084782608
G1200310014406,12,31,14406,12,619,631,0.019017432
G1200310014408,12,31,14408,50,185,235,0.21276596
G1200310014409,12,31,14409,36,774,810,0.044444446
G1200310014410,12,31,14410,62,555,617,0.10048623
G1200310014411,12,31,14411,0,590,590,0
G1200310014412,12,31,14412,78,1686,1764,0.044217687
G1200310014413,12,31,14413,92,398,490,0.18775511
G1200310014500,12,31,14500,118,266,384,0.30729166
G1200310014601,12,31,14601,33,445,478,0.069037654
G1200310014603,12,31,14603,0,415,415,0
G1200310014604,12,31,14604,51,282,333,0.15315315
G1200310014701,12,31,14701,172,568,740,0.23243243
G1200310014702,12,31,14702,81,210,291,0.2783505
G1200310014800,12,31,14800,27,247,274,0.09854015
G1200310014901,12,31,14901,72,490,562,0.12811388
G1200310014902,12,31,14902,91,560,651,0.13978495
G1200310015001,12,31,15001,65,372,437,0.14874142
G1200310015002,12,31,15002,64,204,268,0.23880596
G1200310015100,12,31,15100,82,310,392,0.20918368
G1200310015200,12,31,15200,90,177,267,0.33707866
G1200310015300,12,31,15300,42,146,188,0.22340426
G1200310015400,12,31,15400,40,143,183,0.21857923
G1200310015501,12,31,15501,153,117,270,0.56666666
G1200310015502,12,31,15502,257,367,624,0.41185898
G1200310015600,12,31,15600,83,273,356,0.23314607
G1200310015700,12,31,15700,29,245,274,0.10583942
G1200310015801,12,31,15801,176,409,585,0.30085471
G1200310015802,12,31,15802,413,319,732,0.56420767
G1200310015922,12,31,15922,0,156,156,0
G1200310015923,12,31,15923,354,357,711,0.49789029
G1200310015924,12,31,15924,36,410,446,0.080717489
G1200310015925,12,31,15925,16,284,300,0.053333335
G1200310015926,12,31,15926,36,323,359,0.10027855
G1200310016000,12,31,16000,113,411,524,0.21564886
G1200310016100,12,31,16100,346,424,770,0.44935066
G1200310016200,12,31,16200,43,111,154,0.27922079
G1200310016300,12,31,16300,29,175,204,0.14215687
G1200310016400,12,31,16400,136,457,593,0.22934233
G1200310016500,12,31,16500,53,397,450,0.11777778
G1200310016601,12,31,16601,188,395,583,0.32246998
G1200310016603,12,31,16603,26,262,288,0.090277776
G1200310016604,12,31,16604,67,301,368,0.18206522
G1200310016711,12,31,16711,10,265,275,0.036363635
G1200310016722,12,31,16722,77,545,622,0.12379421
G1200310016724,12,31,16724,19,306,325,0.058461539
G1200310016725,12,31,16725,91,335,426,0.21361503
G1200310016726,12,31,16726,46,274,320,0.14375
G1200310016727,12,31,16727,0,165,165,0
G1200310016728,12,31,16728,38,369,407,0.093366094
G1200310016729,12,31,16729,0,537,537,0
G1200310016801,12,31,16801,24,179,203,0.1182266
G1200310016803,12,31,16803,14,641,655,0.021374045
G1200310016804,12,31,16804,37,575,612,0.060457516
G1200310016805,12,31,16805,34,851,885,0.038418081
G1200310016806,12,31,16806,0,882,882,0
G1200310016807,12,31,16807,62,302,364,0.17032968
G1200310016808,12,31,16808,27,289,316,0.085443035
G1200310017100,12,31,17100,33,192,225,0.14666666
G1200310017200,12,31,17200,19,49,68,0.27941176
G1200310017300,12,31,17300,148,508,656,0.22560975
G1200310017400,12,31,17400,132,147,279,0.47311828
G1200310990000,12,31,990000,0,0,0,
G1200330000100,12,33,100,18,42,60,0.30000001
G1200330000300,12,33,300,17,72,89,0.19101124
G1200330000400,12,33,400,143,144,287,0.49825785
G1200330000500,12,33,500,31,35,66,0.46969697
G1200330000600,12,33,600,42,113,155,0.27096775
G1200330000800,12,33,800,67,226,293,0.22866894
G1200330000900,12,33,900,0,151,151,0
G1200330001001,12,33,1001,40,502,542,0.073800735
G1200330001002,12,33,1002,20,171,191,0.10471204
G1200330001101,12,33,1101,32,329,361,0.088642657
G1200330001103,12,33,1103,0,185,185,0
G1200330001104,12,33,1104,91,470,561,0.16221035
G1200330001201,12,33,1201,126,176,302,0.41721854
G1200330001202,12,33,1202,63,323,386,0.16321243
G1200330001300,12,33,1300,148,186,334,0.44311377
G1200330001401,12,33,1401,8,74,82,0.097560972
G1200330001402,12,33,1402,188,380,568,0.3309859
G1200330001500,12,33,1500,28,102,130,0.21538462
G1200330001600,12,33,1600,67,21,88,0.76136363
G1200330001700,12,33,1700,99,83,182,0.54395604
G1200330001800,12,33,1800,66,68,134,0.49253732
G1200330001900,12,33,1900,92,99,191,0.48167539
G1200330002000,12,33,2000,122,32,154,0.79220778
G1200330002100,12,33,2100,208,174,382,0.54450262
G1200330002200,12,33,2200,122,105,227,0.53744495
G1200330002300,12,33,2300,199,175,374,0.53208554
G1200330002400,12,33,2400,3,121,124,0.024193548
G1200330002500,12,33,2500,50,184,234,0.21367522
G1200330002601,12,33,2601,7,136,143,0.048951048
G1200330002602,12,33,2602,0,49,49,0
G1200330002603,12,33,2603,32,607,639,0.050078247
G1200330002604,12,33,2604,22,351,373,0.058981232
G1200330002605,12,33,2605,53,428,481,0.11018711
G1200330002701,12,33,2701,20,223,243,0.08230453
G1200330002703,12,33,2703,99,91,190,0.52105266
G1200330002704,12,33,2704,62,295,357,0.17366947
G1200330002801,12,33,2801,86,71,157,0.54777068
G1200330002802,12,33,2802,11,153,164,0.067073174
G1200330002803,12,33,2803,57,118,175,0.32571429
G1200330002804,12,33,2804,19,127,146,0.13013698
G1200330002900,12,33,2900,112,160,272,0.41176471
G1200330003000,12,33,3000,81,418,499,0.16232465
G1200330003100,12,33,3100,68,154,222,0.3063063
G1200330003201,12,33,3201,35,249,284,0.12323944
G1200330003203,12,33,3203,83,306,389,0.21336761
G1200330003204,12,33,3204,0,360,360,0
G1200330003301,12,33,3301,49,243,292,0.16780822
G1200330003305,12,33,3305,9,136,145,0.062068965
G1200330003306,12,33,3306,39,469,508,0.076771654
G1200330003307,12,33,3307,71,181,252,0.28174603
G1200330003308,12,33,3308,10,248,258,0.03875969
G1200330003309,12,33,3309,164,259,423,0.38770685
G1200330003400,12,33,3400,67,397,464,0.14439656
G1200330003503,12,33,3503,90,402,492,0.18292683
G1200330003505,12,33,3505,24,186,210,0.11428571
G1200330003506,12,33,3506,144,349,493,0.29208925
G1200330003507,12,33,3507,0,396,396,0
G1200330003508,12,33,3508,166,373,539,0.30797774
G1200330003603,12,33,3603,25,522,547,0.04570384
G1200330003607,12,33,3607,1,66,67,0.014925373
G1200330003608,12,33,3608,153,484,637,0.24018839
G1200330003609,12,33,3609,77,262,339,0.22713864
G1200330003610,12,33,3610,30,577,607,0.049423393
G1200330003611,12,33,3611,25,342,367,0.068119891
G1200330003612,12,33,3612,0,359,359,0
G1200330003613,12,33,3613,111,201,312,0.35576922
G1200330003614,12,33,3614,0,370,370,0
G1200330003700,12,33,3700,102,217,319,0.31974921
G1200330003800,12,33,3800,106,285,391,0.27109975
G1200330003900,12,33,3900,142,202,344,0.41279069
G1200330004000,12,33,4000,21,77,98,0.21428572
G1200330990000,12,33,990000,0,0,0,
G1200350060103,12,35,60103,21,44,65,0.32307693
G1200350060104,12,35,60104,33,185,218,0.15137614
G1200350060105,12,35,60105,27,175,202,0.13366337
G1200350060106,12,35,60106,24,71,95,0.25263157
G1200350060107,12,35,60107,162,225,387,0.41860464
G1200350060204,12,35,60204,254,550,804,0.31592041
G1200350060205,12,35,60205,164,645,809,0.20271941
G1200350060206,12,35,60206,0,335,335,0
G1200350060207,12,35,60207,145,218,363,0.39944905
G1200350060208,12,35,60208,70,405,475,0.14736842
G1200350060209,12,35,60209,56,462,518,0.10810811
G1200350060210,12,35,60210,80,103,183,0.43715847
G1200350060211,12,35,60211,69,311,380,0.18157895
G1200350060212,12,35,60212,127,251,378,0.33597884
G1200350060213,12,35,60213,122,356,478,0.25523013
G1200350060214,12,35,60214,215,805,1020,0.21078432
G1200350060301,12,35,60301,38,223,261,0.14559387
G1200350060302,12,35,60302,9,184,193,0.046632126
G1200350060303,12,35,60303,0,59,59,0
G1200350060304,12,35,60304,0,112,112,0
G1200350990000,12,35,990000,0,0,0,
G1200370970100,12,37,970100,129,139,268,0.48134327
G1200370970200,12,37,970200,73,190,263,0.27756655
G1200370970302,12,37,970302,52,189,241,0.21576764
G1200370970304,12,37,970304,13,84,97,0.13402061
G1200370990000,12,37,990000,0,0,0,
G1200370990100,12,37,990100,0,0,0,
G1200390020101,12,39,20101,32,263,295,0.10847457
G1200390020102,12,39,20102,189,286,475,0.39789474
G1200390020300,12,39,20300,263,461,724,0.36325967
G1200390020400,12,39,20400,94,288,382,0.24607331
G1200390020500,12,39,20500,66,311,377,0.17506631
G1200390020600,12,39,20600,110,434,544,0.20220588
G1200390020701,12,39,20701,134,160,294,0.45578232
G1200390020702,12,39,20702,554,389,943,0.58748674
G1200390020800,12,39,20800,252,344,596,0.42281878
G1200410950100,12,41,950100,167,212,379,0.44063324
G1200410950201,12,41,950201,26,121,147,0.17687075
G1200410950202,12,41,950202,58,112,170,0.34117648
G1200410950203,12,41,950203,59,189,248,0.23790322
G1200410950204,12,41,950204,93,313,406,0.22906403
G1200430000100,12,43,100,0,55,55,0
G1200430000200,12,43,200,185,291,476,0.38865545
G1200430000300,12,43,300,73,124,197,0.37055838
G1200430990000,12,43,990000,0,0,0,
G1200450960100,12,45,960100,86,588,674,0.12759644
G1200450960200,12,45,960200,31,222,253,0.12252964
G1200450960300,12,45,960300,52,304,356,0.14606741
G1200450990000,12,45,990000,0,0,0,
G1200470960100,12,47,960100,257,214,471,0.54564756
G1200470960200,12,47,960200,186,382,568,0.32746479
G1200470960300,12,47,960300,97,109,206,0.47087377
G1200490970101,12,49,970101,119,220,339,0.35103244
G1200490970102,12,49,970102,132,167,299,0.44147158
G1200490970201,12,49,970201,129,204,333,0.38738739
G1200490970202,12,49,970202,18,80,98,0.18367347
G1200490970300,12,49,970300,316,447,763,0.41415465
G1200490970400,12,49,970400,119,409,528,0.22537878
G1200510000100,12,51,100,233,645,878,0.26537585
G1200510000200,12,51,200,253,473,726,0.34848484
G1200510000300,12,51,300,251,387,638,0.39341694
G1200510000401,12,51,401,173,197,370,0.46756756
G1200510000402,12,51,402,151,692,843,0.17912218
G1200510000600,12,51,600,103,281,384,0.26822916
G1200510990000,12,51,990000,0,0,0,
G1200530040101,12,53,40101,59,243,302,0.19536424
G1200530040102,12,53,40102,47,132,179,0.26256984
G1200530040201,12,53,40201,77,205,282,0.27304965
G1200530040202,12,53,40202,272,237,509,0.53438115
G1200530040301,12,53,40301,32,101,133,0.24060151
G1200530040302,12,53,40302,94,233,327,0.28746179
G1200530040303,12,53,40303,46,95,141,0.32624114
G1200530040400,12,53,40400,32,65,97,0.3298969
G1200530040501,12,53,40501,76,270,346,0.21965317
G1200530040502,12,53,40502,115,187,302,0.3807947
G1200530040601,12,53,40601,59,129,188,0.31382978
G1200530040602,12,53,40602,43,236,279,0.15412186
G1200530040701,12,53,40701,61,582,643,0.094867811
G1200530040702,12,53,40702,146,361,507,0.28796843
G1200530040801,12,53,40801,25,140,165,0.15151516
G1200530040802,12,53,40802,17,219,236,0.072033897
G1200530040901,12,53,40901,43,337,380,0.1131579
G1200530040905,12,53,40905,0,355,355,0
G1200530040906,12,53,40906,68,501,569,0.11950791
G1200530040907,12,53,40907,33,224,257,0.12840466
G1200530040908,12,53,40908,184,875,1059,0.17374882
G1200530040909,12,53,40909,50,445,495,0.1010101
G1200530040910,12,53,40910,69,141,210,0.32857144
G1200530040911,12,53,40911,33,241,274,0.12043796
G1200530041003,12,53,41003,125,168,293,0.42662117
G1200530041004,12,53,41004,206,613,819,0.25152627
G1200530041005,12,53,41005,57,187,244,0.23360656
G1200530041006,12,53,41006,159,531,690,0.23043478
G1200530041103,12,53,41103,189,264,453,0.41721854
G1200530041104,12,53,41104,44,206,250,0.176
G1200530041105,12,53,41105,118,253,371,0.3180593
G1200530041106,12,53,41106,80,324,404,0.1980198
G1200530041201,12,53,41201,162,256,418,0.3875598
G1200530041203,12,53,41203,87,270,357,0.24369748
G1200530041204,12,53,41204,149,191,340,0.43823528
G1200530041302,12,53,41302,139,86,225,0.61777776
G1200530041303,12,53,41303,0,9,9,0
G1200530041304,12,53,41304,22,1,23,0.95652175
G1200530041305,12,53,41305,0,11,11,0
G1200530041401,12,53,41401,150,174,324,0.46296296
G1200530041402,12,53,41402,61,439,500,0.122
G1200530041501,12,53,41501,79,131,210,0.37619048
G1200530041502,12,53,41502,27,160,187,0.14438502
G1200530041600,12,53,41600,27,186,213,0.12676056
G1200530990000,12,53,990000,0,0,0,
G1200550960101,12,55,960101,16,117,133,0.12030075
G1200550960102,12,55,960102,70,77,147,0.47619048
G1200550960103,12,55,960103,72,173,245,0.29387754
G1200550960200,12,55,960200,143,230,373,0.38337803
G1200550960300,12,55,960300,243,218,461,0.52711499
G1200550960400,12,55,960400,181,357,538,0.33643124
G1200550960501,12,55,960501,0,70,70,0
G1200550960502,12,55,960502,85,390,475,0.17894737
G1200550960601,12,55,960601,16,187,203,0.078817733
G1200550960602,12,55,960602,13,273,286,0.045454547
G1200550960700,12,55,960700,49,227,276,0.17753623
G1200550960800,12,55,960800,39,123,162,0.24074075
G1200550960900,12,55,960900,41,115,156,0.26282051
G1200550961000,12,55,961000,68,161,229,0.29694322
G1200550961100,12,55,961100,172,105,277,0.6209386
G1200550961200,12,55,961200,40,252,292,0.1369863
G1200550961301,12,55,961301,0,498,498,0
G1200550961302,12,55,961302,0,164,164,0
G1200550961400,12,55,961400,12,294,306,0.039215688
G1200550961500,12,55,961500,92,196,288,0.31944445
G1200550961601,12,55,961601,0,40,40,0
G1200550961602,12,55,961602,0,89,89,0
G1200550961603,12,55,961603,320,218,538,0.59479553
G1200550961700,12,55,961700,27,333,360,0.075000003
G1200550980000,12,55,980000,0,0,0,
G1200550980100,12,55,980100,0,0,0,
G1200550980200,12,55,980200,0,0,0,
G1200570000101,12,57,101,105,80,185,0.56756759
G1200570000102,12,57,102,330,279,609,0.54187191
G1200570000201,12,57,201,125,32,157,0.79617834
G1200570000202,12,57,202,132,341,473,0.27906978
G1200570000300,12,57,300,162,518,680,0.23823529
G1200570000401,12,57,401,69,172,241,0.28630707
G1200570000402,12,57,402,152,221,373,0.4075067
G1200570000500,12,57,500,31,216,247,0.12550607
G1200570000601,12,57,601,88,425,513,0.17153996
G1200570000602,12,57,602,78,110,188,0.41489363
G1200570000700,12,57,700,332,292,624,0.53205127
G1200570000800,12,57,800,109,116,225,0.48444444
G1200570000901,12,57,901,90,255,345,0.26086956
G1200570000902,12,57,902,48,218,266,0.18045112
G1200570001001,12,57,1001,184,150,334,0.55089819
G1200570001002,12,57,1002,202,242,444,0.45495495
G1200570001100,12,57,1100,53,174,227,0.23348017
G1200570001200,12,57,1200,105,137,242,0.43388429
G1200570001300,12,57,1300,80,559,639,0.12519562
G1200570001400,12,57,1400,267,254,521,0.51247603
G1200570001500,12,57,1500,69,161,230,0.30000001
G1200570001600,12,57,1600,47,104,151,0.31125829
G1200570001700,12,57,1700,190,222,412,0.46116504
G1200570001800,12,57,1800,269,138,407,0.66093367
G1200570001900,12,57,1900,195,154,349,0.55873924
G1200570002000,12,57,2000,98,158,256,0.3828125
G1200570002100,12,57,2100,85,156,241,0.3526971
G1200570002200,12,57,2200,26,114,140,0.18571429
G1200570002300,12,57,2300,0,204,204,0
G1200570002400,12,57,2400,108,245,353,0.305949
G1200570002500,12,57,2500,251,530,781,0.32138285
G1200570002600,12,57,2600,55,54,109,0.50458717
G1200570002700,12,57,2700,334,472,806,0.41439205
G1200570002800,12,57,2800,57,126,183,0.3114754
G1200570002900,12,57,2900,76,91,167,0.45508981
G1200570003000,12,57,3000,168,82,250,0.67199999
G1200570003100,12,57,3100,173,170,343,0.50437319
G1200570003200,12,57,3200,93,88,181,0.51381218
G1200570003300,12,57,3300,85,92,177,0.48022598
G1200570003400,12,57,3400,218,133,351,0.6210826
G1200570003500,12,57,3500,138,136,274,0.50364965
G1200570003600,12,57,3600,255,241,496,0.51411289
G1200570003700,12,57,3700,62,19,81,0.76543212
G1200570003800,12,57,3800,37,35,72,0.5138889
G1200570003900,12,57,3900,72,25,97,0.74226803
G1200570004000,12,57,4000,4,0,4,1
G1200570004100,12,57,4100,0,72,72,0
G1200570004200,12,57,4200,20,32,52,0.38461539
G1200570004300,12,57,4300,375,132,507,0.73964494
G1200570004400,12,57,4400,71,104,175,0.40571427
G1200570004500,12,57,4500,123,280,403,0.30521092
G1200570004600,12,57,4600,22,193,215,0.10232558
G1200570004700,12,57,4700,15,115,130,0.11538462
G1200570004800,12,57,4800,48,229,277,0.1732852
G1200570004900,12,57,4900,15,79,94,0.15957446
G1200570005000,12,57,5000,90,76,166,0.54216868
G1200570005101,12,57,5101,0,3,3,0
G1200570005102,12,57,5102,0,247,247,0
G1200570005301,12,57,5301,0,34,34,0
G1200570005302,12,57,5302,52,77,129,0.40310079
G1200570005401,12,57,5401,16,541,557,0.028725315
G1200570005500,12,57,5500,14,93,107,0.13084112
G1200570005700,12,57,5700,0,175,175,0
G1200570005800,12,57,5800,12,385,397,0.0302267
G1200570005900,12,57,5900,103,707,810,0.12716049
G1200570006000,12,57,6000,14,634,648,0.021604938
G1200570006101,12,57,6101,20,295,315,0.063492067
G1200570006103,12,57,6103,16,176,192,0.083333336
G1200570006200,12,57,6200,6,368,374,0.01604278
G1200570006300,12,57,6300,0,438,438,0
G1200570006400,12,57,6400,30,492,522,0.057471264
G1200570006501,12,57,6501,61,214,275,0.22181818
G1200570006502,12,57,6502,0,85,85,0
G1200570006600,12,57,6600,15,252,267,0.056179777
G1200570006700,12,57,6700,34,422,456,0.074561402
G1200570006801,12,57,6801,0,276,276,0
G1200570006802,12,57,6802,35,250,285,0.12280702
G1200570006900,12,57,6900,41,440,481,0.085239083
G1200570007001,12,57,7001,30,231,261,0.11494253
G1200570007002,12,57,7002,227,240,467,0.48608136
G1200570007102,12,57,7102,34,137,171,0.19883041
G1200570007103,12,57,7103,144,386,530,0.27169812
G1200570007200,12,57,7200,107,310,417,0.25659472
G1200570007300,12,57,7300,34,255,289,0.11764706
G1200570010103,12,57,10103,87,341,428,0.20327103
G1200570010105,12,57,10105,57,477,534,0.10674157
G1200570010106,12,57,10106,123,443,566,0.21731448
G1200570010107,12,57,10107,74,166,240,0.30833334
G1200570010108,12,57,10108,1,179,180,0.005555556
G1200570010203,12,57,10203,43,166,209,0.20574163
G1200570010204,12,57,10204,112,368,480,0.23333333
G1200570010205,12,57,10205,91,1131,1222,0.074468084
G1200570010209,12,57,10209,111,1468,1579,0.070297658
G1200570010210,12,57,10210,217,339,556,0.39028776
G1200570010211,12,57,10211,92,451,543,0.16942909
G1200570010212,12,57,10212,73,597,670,0.10895523
G1200570010213,12,57,10213,49,143,192,0.25520834
G1200570010214,12,57,10214,5,0,5,1
G1200570010303,12,57,10303,102,262,364,0.28021979
G1200570010304,12,57,10304,58,313,371,0.15633424
G1200570010305,12,57,10305,117,163,280,0.41785714
G1200570010401,12,57,10401,150,306,456,0.32894737
G1200570010402,12,57,10402,204,310,514,0.39688715
G1200570010501,12,57,10501,135,409,544,0.24816176
G1200570010502,12,57,10502,38,200,238,0.15966387
G1200570010600,12,57,10600,83,208,291,0.28522336
G1200570010701,12,57,10701,106,410,516,0.20542635
G1200570010702,12,57,10702,70,144,214,0.32710281
G1200570010805,12,57,10805,250,254,504,0.49603173
G1200570010808,12,57,10808,154,69,223,0.69058293
G1200570010809,12,57,10809,65,207,272,0.23897059
G1200570010810,12,57,10810,0,207,207,0
G1200570010811,12,57,10811,58,478,536,0.10820895
G1200570010812,12,57,10812,65,115,180,0.3611111
G1200570010813,12,57,10813,27,5,32,0.84375
G1200570010814,12,57,10814,66,107,173,0.3815029
G1200570010815,12,57,10815,44,110,154,0.2857143
G1200570010816,12,57,10816,199,144,343,0.58017492
G1200570010817,12,57,10817,194,277,471,0.41188958
G1200570010818,12,57,10818,255,240,495,0.5151515
G1200570010900,12,57,10900,0,0,0,
G1200570011003,12,57,11003,96,285,381,0.2519685
G1200570011005,12,57,11005,60,287,347,0.17291066
G1200570011006,12,57,11006,38,451,489,0.077709608
G1200570011007,12,57,11007,14,385,399,0.03508772
G1200570011008,12,57,11008,65,709,774,0.083979331
G1200570011010,12,57,11010,0,196,196,0
G1200570011012,12,57,11012,52,819,871,0.059701491
G1200570011013,12,57,11013,89,421,510,0.17450981
G1200570011014,12,57,11014,0,54,54,0
G1200570011015,12,57,11015,148,393,541,0.27356747
G1200570011016,12,57,11016,20,394,414,0.048309177
G1200570011103,12,57,11103,52,333,385,0.13506493
G1200570011106,12,57,11106,37,108,145,0.2551724
G1200570011107,12,57,11107,42,685,727,0.057771664
G1200570011108,12,57,11108,0,75,75,0
G1200570011109,12,57,11109,10,236,246,0.040650405
G1200570011203,12,57,11203,0,259,259,0
G1200570011204,12,57,11204,149,366,515,0.28932038
G1200570011205,12,57,11205,66,227,293,0.22525597
G1200570011206,12,57,11206,32,174,206,0.15533981
G1200570011301,12,57,11301,55,170,225,0.24444444
G1200570011303,12,57,11303,23,298,321,0.071651094
G1200570011304,12,57,11304,20,607,627,0.031897925
G1200570011407,12,57,11407,29,115,144,0.2013889
G1200570011408,12,57,11408,0,327,327,0
G1200570011409,12,57,11409,8,257,265,0.03018868
G1200570011410,12,57,11410,0,745,745,0
G1200570011411,12,57,11411,6,186,192,0.03125
G1200570011412,12,57,11412,78,317,395,0.19746836
G1200570011413,12,57,11413,32,563,595,0.053781513
G1200570011414,12,57,11414,251,636,887,0.28297633
G1200570011415,12,57,11415,64,373,437,0.14645308
G1200570011416,12,57,11416,166,523,689,0.24092889
G1200570011417,12,57,11417,72,457,529,0.13610587
G1200570011418,12,57,11418,0,288,288,0
G1200570011504,12,57,11504,44,161,205,0.21463415
G1200570011506,12,57,11506,127,1040,1167,0.10882605
G1200570011507,12,57,11507,28,770,798,0.03508772
G1200570011509,12,57,11509,0,855,855,0
G1200570011510,12,57,11510,20,621,641,0.031201247
G1200570011512,12,57,11512,0,443,443,0
G1200570011514,12,57,11514,130,581,711,0.18284106
G1200570011515,12,57,11515,0,351,351,0
G1200570011516,12,57,11516,0,245,245,0
G1200570011517,12,57,11517,22,1246,1268,0.017350158
G1200570011518,12,57,11518,0,320,320,0
G1200570011519,12,57,11519,0,198,198,0
G1200570011520,12,57,11520,0,616,616,0
G1200570011521,12,57,11521,289,349,638,0.45297804
G1200570011522,12,57,11522,82,448,530,0.15471698
G1200570011523,12,57,11523,0,208,208,0
G1200570011524,12,57,11524,79,405,484,0.16322315
G1200570011603,12,57,11603,45,360,405,0.11111111
G1200570011605,12,57,11605,49,540,589,0.083191849
G1200570011606,12,57,11606,10,751,761,0.013140605
G1200570011607,12,57,11607,243,710,953,0.25498426
G1200570011608,12,57,11608,0,104,104,0
G1200570011610,12,57,11610,136,276,412,0.33009708
G1200570011611,12,57,11611,86,359,445,0.19325842
G1200570011612,12,57,11612,135,513,648,0.20833333
G1200570011613,12,57,11613,360,331,691,0.52098405
G1200570011614,12,57,11614,276,351,627,0.44019139
G1200570011615,12,57,11615,116,396,512,0.2265625
G1200570011706,12,57,11706,190,415,605,0.3140496
G1200570011708,12,57,11708,14,239,253,0.055335969
G1200570011709,12,57,11709,0,70,70,0
G1200570011710,12,57,11710,76,432,508,0.1496063
G1200570011712,12,57,11712,96,315,411,0.23357664
G1200570011802,12,57,11802,208,432,640,0.32499999
G1200570011803,12,57,11803,332,531,863,0.38470453
G1200570011804,12,57,11804,247,488,735,0.33605441
G1200570011901,12,57,11901,134,262,396,0.33838382
G1200570011902,12,57,11902,332,562,894,0.37136465
G1200570011904,12,57,11904,23,97,120,0.19166666
G1200570011905,12,57,11905,66,118,184,0.35869566
G1200570011906,12,57,11906,172,212,384,0.44791666
G1200570012001,12,57,12001,118,125,243,0.48559672
G1200570012002,12,57,12002,152,282,434,0.35023043
G1200570012103,12,57,12103,32,570,602,0.053156145
G1200570012104,12,57,12104,426,612,1038,0.41040462
G1200570012106,12,57,12106,157,439,596,0.26342282
G1200570012107,12,57,12107,63,401,464,0.13577586
G1200570012108,12,57,12108,6,283,289,0.020761246
G1200570012206,12,57,12206,42,581,623,0.067415729
G1200570012207,12,57,12207,55,446,501,0.10978044
G1200570012208,12,57,12208,0,707,707,0
G1200570012209,12,57,12209,56,453,509,0.11001965
G1200570012210,12,57,12210,48,380,428,0.11214953
G1200570012211,12,57,12211,0,13,13,0
G1200570012212,12,57,12212,217,336,553,0.39240506
G1200570012213,12,57,12213,52,368,420,0.12380952
G1200570012301,12,57,12301,13,432,445,0.029213483
G1200570012303,12,57,12303,30,205,235,0.12765957
G1200570012304,12,57,12304,213,370,583,0.36535162
G1200570012401,12,57,12401,181,295,476,0.38025209
G1200570012402,12,57,12402,73,172,245,0.29795918
G1200570012403,12,57,12403,124,590,714,0.17366947
G1200570012501,12,57,12501,87,242,329,0.26443768
G1200570012503,12,57,12503,93,420,513,0.18128654
G1200570012504,12,57,12504,16,330,346,0.046242774
G1200570012600,12,57,12600,148,396,544,0.27205881
G1200570012701,12,57,12701,259,660,919,0.28182808
G1200570012702,12,57,12702,0,278,278,0
G1200570012800,12,57,12800,95,285,380,0.25
G1200570012900,12,57,12900,104,215,319,0.32601881
G1200570013001,12,57,13001,79,415,494,0.15991902
G1200570013002,12,57,13002,95,463,558,0.17025089
G1200570013003,12,57,13003,116,194,310,0.37419355
G1200570013004,12,57,13004,62,274,336,0.18452381
G1200570013100,12,57,13100,24,249,273,0.08791209
G1200570013203,12,57,13203,33,375,408,0.080882356
G1200570013204,12,57,13204,47,113,160,0.29374999
G1200570013205,12,57,13205,27,828,855,0.031578947
G1200570013206,12,57,13206,34,629,663,0.051282052
G1200570013207,12,57,13207,77,389,466,0.16523606
G1200570013208,12,57,13208,10,505,515,0.019417476
G1200570013305,12,57,13305,29,436,465,0.062365592
G1200570013307,12,57,13307,70,200,270,0.25925925
G1200570013310,12,57,13310,53,218,271,0.19557196
G1200570013311,12,57,13311,64,162,226,0.28318584
G1200570013312,12,57,13312,49,518,567,0.086419754
G1200570013313,12,57,13313,91,441,532,0.17105263
G1200570013314,12,57,13314,62,268,330,0.18787879
G1200570013315,12,57,13315,29,274,303,0.09570957
G1200570013316,12,57,13316,56,136,192,0.29166666
G1200570013317,12,57,13317,16,102,118,0.13559322
G1200570013318,12,57,13318,46,314,360,0.12777779
G1200570013319,12,57,13319,35,320,355,0.098591551
G1200570013320,12,57,13320,139,292,431,0.3225058
G1200570013321,12,57,13321,76,549,625,0.1216
G1200570013322,12,57,13322,98,490,588,0.16666667
G1200570013406,12,57,13406,46,92,138,0.33333334
G1200570013407,12,57,13407,18,689,707,0.025459688
G1200570013409,12,57,13409,82,526,608,0.13486843
G1200570013410,12,57,13410,105,494,599,0.17529215
G1200570013411,12,57,13411,10,136,146,0.06849315
G1200570013412,12,57,13412,15,355,370,0.040540539
G1200570013413,12,57,13413,0,348,348,0
G1200570013414,12,57,13414,46,722,768,0.059895832
G1200570013415,12,57,13415,18,434,452,0.039823011
G1200570013501,12,57,13501,138,240,378,0.36507937
G1200570013503,12,57,13503,142,265,407,0.34889436
G1200570013504,12,57,13504,150,280,430,0.3488372
G1200570013505,12,57,13505,168,276,444,0.37837839
G1200570013602,12,57,13602,82,132,214,0.38317758
G1200570013604,12,57,13604,53,53,106,0.5
G1200570013702,12,57,13702,246,823,1069,0.23012161
G1200570013703,12,57,13703,91,553,644,0.14130434
G1200570013704,12,57,13704,157,788,945,0.16613756
G1200570013801,12,57,13801,153,154,307,0.49837133
G1200570013802,12,57,13802,71,248,319,0.22257054
G1200570013803,12,57,13803,47,79,126,0.37301588
G1200570013804,12,57,13804,128,1121,1249,0.10248198
G1200570013806,12,57,13806,45,103,148,0.30405405
G1200570013807,12,57,13807,83,648,731,0.11354309
G1200570013903,12,57,13903,90,362,452,0.19911504
G1200570013907,12,57,13907,0,224,224,0
G1200570013908,12,57,13908,87,889,976,0.089139342
G1200570013912,12,57,13912,96,290,386,0.24870466
G1200570013913,12,57,13913,264,435,699,0.37768242
G1200570013914,12,57,13914,157,342,499,0.31462926
G1200570013915,12,57,13915,25,782,807,0.030978935
G1200570013916,12,57,13916,0,1402,1402,0
G1200570013917,12,57,13917,5,964,969,0.005159959
G1200570013918,12,57,13918,97,140,237,0.40928271
G1200570013919,12,57,13919,14,646,660,0.021212121
G1200570013920,12,57,13920,82,486,568,0.14436619
G1200570013921,12,57,13921,24,343,367,0.065395094
G1200570013922,12,57,13922,0,881,881,0
G1200570013923,12,57,13923,58,861,919,0.06311208
G1200570014002,12,57,14002,148,21,169,0.87573963
G1200570014003,12,57,14003,6,73,79,0.075949363
G1200570014007,12,57,14007,27,378,405,0.06666667
G1200570014008,12,57,14008,0,0,0,
G1200570014009,12,57,14009,0,47,47,0
G1200570014010,12,57,14010,0,0,0,
G1200570014011,12,57,14011,0,0,0,
G1200570014012,12,57,14012,0,0,0,
G1200570014013,12,57,14013,35,91,126,0.27777779
G1200570014014,12,57,14014,0,0,0,
G1200570014015,12,57,14015,0,0,0,
G1200570014016,12,57,14016,0,0,0,
G1200570014104,12,57,14104,9,60,69,0.13043478
G1200570014106,12,57,14106,77,120,197,0.39086294
G1200570014108,12,57,14108,140,405,545,0.25688073
G1200570014109,12,57,14109,155,578,733,0.21145976
G1200570014117,12,57,14117,20,121,141,0.14184397
G1200570014118,12,57,14118,13,315,328,0.039634146
G1200570014119,12,57,14119,40,529,569,0.070298769
G1200570014121,12,57,14121,7,560,567,0.012345679
G1200570014122,12,57,14122,74,451,525,0.14095238
G1200570980100,12,57,980100,0,0,0,
G1200570980200,12,57,980200,0,0,0,
G1200570980300,12,57,980300,0,0,0,
G1200570980400,12,57,980400,0,0,0,
G1200570980500,12,57,980500,0,4,4,0
G1200570980600,12,57,980600,0,0,0,
G1200570980700,12,57,980700,0,0,0,
G1200570990000,12,57,990000,0,0,0,
G1200570990100,12,57,990100,0,0,0,
G1200590960100,12,59,960100,145,349,494,0.29352227
G1200590960200,12,59,960200,274,334,608,0.4506579
G1200590960300,12,59,960300,37,92,129,0.28682169
G1200590960400,12,59,960400,83,274,357,0.232493
G1200610050100,12,61,50100,140,265,405,0.34567901
G1200610050200,12,61,50200,40,164,204,0.19607843
G1200610050301,12,61,50301,0,165,165,0
G1200610050302,12,61,50302,376,287,663,0.56711918
G1200610050401,12,61,50401,61,219,280,0.21785714
G1200610050402,12,61,50402,0,80,80,0
G1200610050501,12,61,50501,0,87,87,0
G1200610050503,12,61,50503,37,176,213,0.17370892
G1200610050504,12,61,50504,0,97,97,0
G1200610050505,12,61,50505,0,88,88,0
G1200610050601,12,61,50601,41,107,148,0.27702704
G1200610050602,12,61,50602,118,376,494,0.2388664
G1200610050603,12,61,50603,49,268,317,0.15457413
G1200610050604,12,61,50604,0,6,6,0
G1200610050605,12,61,50605,26,27,53,0.49056605
G1200610050606,12,61,50606,161,1014,1175,0.13702127
G1200610050702,12,61,50702,31,453,484,0.064049587
G1200610050703,12,61,50703,84,771,855,0.098245613
G1200610050704,12,61,50704,48,114,162,0.2962963
G1200610050705,12,61,50705,0,145,145,0
G1200610050802,12,61,50802,77,706,783,0.098339722
G1200610050804,12,61,50804,42,379,421,0.09976247
G1200610050805,12,61,50805,77,124,201,0.38308457
G1200610050806,12,61,50806,0,217,217,0
G1200610050807,12,61,50807,54,318,372,0.14516129
G1200610050808,12,61,50808,85,179,264,0.32196969
G1200610050902,12,61,50902,0,158,158,0
G1200610050903,12,61,50903,106,547,653,0.16232772
G1200610050904,12,61,50904,555,381,936,0.59294873
G1200610980000,12,61,980000,0,0,0,
G1200610990000,12,61,990000,0,0,0,
G1200630210100,12,63,210100,88,188,276,0.31884059
G1200630210200,12,63,210200,24,61,85,0.28235295
G1200630210300,12,63,210300,88,270,358,0.24581006
G1200630210400,12,63,210400,102,260,362,0.28176796
G1200630210500,12,63,210500,165,265,430,0.38372093
G1200630210600,12,63,210600,324,340,664,0.48795182
G1200630210700,12,63,210700,148,287,435,0.3402299
G1200630210800,12,63,210800,47,227,274,0.17153284
G1200630210900,12,63,210900,59,285,344,0.17151164
G1200630211000,12,63,211000,58,357,415,0.13975903
G1200630211100,12,63,211100,39,246,285,0.1368421
G1200650250101,12,65,250101,99,309,408,0.24264705
G1200650250102,12,65,250102,62,350,412,0.15048544
G1200650250200,12,65,250200,85,239,324,0.26234567
G1200650990000,12,65,990000,0,0,0,
G1200670960100,12,67,960100,17,90,107,0.15887851
G1200670960200,12,67,960200,162,444,606,0.26732674
G1200690030102,12,69,30102,127,102,229,0.55458516
G1200690030104,12,69,30104,10,75,85,0.11764706
G1200690030105,12,69,30105,164,582,746,0.21983914
G1200690030106,12,69,30106,23,55,78,0.29487181
G1200690030107,12,69,30107,241,360,601,0.40099832
G1200690030108,12,69,30108,93,353,446,0.20852017
G1200690030203,12,69,30203,87,626,713,0.12201963
G1200690030204,12,69,30204,94,203,297,0.31649831
G1200690030206,12,69,30206,135,248,383,0.35248041
G1200690030207,12,69,30207,193,235,428,0.45093459
G1200690030208,12,69,30208,59,364,423,0.13947991
G1200690030209,12,69,30209,50,72,122,0.40983605
G1200690030302,12,69,30302,37,95,132,0.28030303
G1200690030305,12,69,30305,0,110,110,0
G1200690030306,12,69,30306,27,82,109,0.24770643
G1200690030307,12,69,30307,39,224,263,0.14828898
G1200690030308,12,69,30308,72,197,269,0.267658
G1200690030405,12,69,30405,117,381,498,0.23493975
G1200690030406,12,69,30406,56,183,239,0.23430963
G1200690030407,12,69,30407,115,221,336,0.34226191
G1200690030408,12,69,30408,0,128,128,0
G1200690030409,12,69,30409,0,0,0,
G1200690030410,12,69,30410,19,210,229,0.082969435
G1200690030411,12,69,30411,360,335,695,0.51798558
G1200690030502,12,69,30502,218,385,603,0.36152571
G1200690030503,12,69,30503,55,85,140,0.39285713
G1200690030504,12,69,30504,117,329,446,0.26233184
G1200690030601,12,69,30601,88,280,368,0.23913044
G1200690030602,12,69,30602,19,72,91,0.20879121
G1200690030701,12,69,30701,11,205,216,0.050925925
G1200690030702,12,69,30702,102,289,391,0.26086956
G1200690030803,12,69,30803,106,143,249,0.42570281
G1200690030804,12,69,30804,24,65,89,0.26966292
G1200690030805,12,69,30805,58,179,237,0.24472573
G1200690030806,12,69,30806,41,142,183,0.22404371
G1200690030807,12,69,30807,44,191,235,0.18723404
G1200690030902,12,69,30902,39,1075,1114,0.035008978
G1200690030912,12,69,30912,106,361,467,0.22698073
G1200690030913,12,69,30913,0,66,66,0
G1200690030914,12,69,30914,67,344,411,0.16301703
G1200690031000,12,69,31000,76,453,529,0.1436673
G1200690031101,12,69,31101,241,59,300,0.80333334
G1200690031102,12,69,31102,0,165,165,0
G1200690031103,12,69,31103,68,93,161,0.42236024
G1200690031202,12,69,31202,82,696,778,0.10539846
G1200690031203,12,69,31203,54,241,295,0.18305084
G1200690031204,12,69,31204,193,1029,1222,0.15793781
G1200690031205,12,69,31205,44,233,277,0.15884477
G1200690031301,12,69,31301,8,702,710,0.011267605
G1200690031305,12,69,31305,274,665,939,0.29179978
G1200690031306,12,69,31306,154,554,708,0.21751413
G1200690031307,12,69,31307,242,1924,2166,0.11172669
G1200690031308,12,69,31308,0,492,492,0
G1200690031309,12,69,31309,62,1073,1135,0.054625552
G1200690031310,12,69,31310,206,1441,1647,0.12507589
G1200690031311,12,69,31311,507,1202,1709,0.29666471
G1200710000301,12,71,301,195,163,358,0.54469275
G1200710000302,12,71,302,209,164,373,0.56032169
G1200710000401,12,71,401,104,130,234,0.44444445
G1200710000402,12,71,402,112,55,167,0.67065871
G1200710000502,12,71,502,212,158,370,0.57297295
G1200710000503,12,71,503,196,254,450,0.43555555
G1200710000504,12,71,504,83,45,128,0.6484375
G1200710000600,12,71,600,209,205,414,0.5048309
G1200710000700,12,71,700,81,19,100,0.81
G1200710000800,12,71,800,34,18,52,0.65384614
G1200710000900,12,71,900,0,244,244,0
G1200710001000,12,71,1000,104,500,604,0.17218544
G1200710001101,12,71,1101,116,151,267,0.43445691
G1200710001102,12,71,1102,102,105,207,0.49275362
G1200710001201,12,71,1201,238,458,696,0.34195402
G1200710001202,12,71,1202,19,627,646,0.029411765
G1200710001300,12,71,1300,66,106,172,0.38372093
G1200710001401,12,71,1401,202,243,445,0.45393258
G1200710001402,12,71,1402,7,175,182,0.03846154
G1200710001501,12,71,1501,8,119,127,0.062992126
G1200710001502,12,71,1502,211,252,463,0.45572355
G1200710001601,12,71,1601,58,238,296,0.19594595
G1200710001602,12,71,1602,0,71,71,0
G1200710001701,12,71,1701,17,106,123,0.13821138
G1200710001703,12,71,1703,0,73,73,0
G1200710001705,12,71,1705,6,81,87,0.068965517
G1200710001706,12,71,1706,24,103,127,0.18897638
G1200710001707,12,71,1707,18,209,227,0.079295151
G1200710001801,12,71,1801,101,359,460,0.21956521
G1200710001802,12,71,1802,16,54,70,0.22857143
G1200710001903,12,71,1903,0,66,66,0
G1200710001906,12,71,1906,152,304,456,0.33333334
G1200710001907,12,71,1907,0,447,447,0
G1200710001908,12,71,1908,0,9,9,0
G1200710001910,12,71,1910,0,13,13,0
G1200710001911,12,71,1911,0,17,17,0
G1200710001912,12,71,1912,0,31,31,0
G1200710001913,12,71,1913,8,0,8,1
G1200710001914,12,71,1914,78,246,324,0.24074075
G1200710001915,12,71,1915,0,63,63,0
G1200710010102,12,71,10102,104,476,580,0.17931035
G1200710010103,12,71,10103,261,874,1135,0.22995594
G1200710010104,12,71,10104,0,6,6,0
G1200710010105,12,71,10105,113,326,439,0.25740319
G1200710010201,12,71,10201,315,955,1270,0.2480315
G1200710010203,12,71,10203,305,552,857,0.35589266
G1200710010204,12,71,10204,357,563,920,0.38804349
G1200710010302,12,71,10302,239,375,614,0.38925081
G1200710010303,12,71,10303,25,436,461,0.054229934
G1200710010304,12,71,10304,182,749,931,0.19548872
G1200710010305,12,71,10305,86,173,259,0.33204633
G1200710010306,12,71,10306,71,464,535,0.13271028
G1200710010307,12,71,10307,326,520,846,0.38534278
G1200710010404,12,71,10404,86,603,689,0.12481858
G1200710010405,12,71,10405,90,581,671,0.13412817
G1200710010406,12,71,10406,24,481,505,0.047524754
G1200710010407,12,71,10407,65,654,719,0.090403341
G1200710010409,12,71,10409,218,773,991,0.21997982
G1200710010410,12,71,10410,0,1015,1015,0
G1200710010411,12,71,10411,60,424,484,0.12396694
G1200710010412,12,71,10412,77,280,357,0.21568628
G1200710010501,12,71,10501,64,175,239,0.26778242
G1200710010502,12,71,10502,31,362,393,0.078880407
G1200710010601,12,71,10601,104,292,396,0.26262626
G1200710010602,12,71,10602,41,100,141,0.29078013
G1200710010701,12,71,10701,80,120,200,0.40000001
G1200710010702,12,71,10702,0,108,108,0
G1200710010801,12,71,10801,0,80,80,0
G1200710010802,12,71,10802,28,132,160,0.175
G1200710010803,12,71,10803,28,115,143,0.19580419
G1200710020101,12,71,20101,0,105,105,0
G1200710020102,12,71,20102,59,124,183,0.32240438
G1200710020201,12,71,20201,20,55,75,0.26666668
G1200710020202,12,71,20202,17,176,193,0.088082902
G1200710020300,12,71,20300,258,126,384,0.671875
G1200710020400,12,71,20400,25,163,188,0.13297872
G1200710020501,12,71,20501,0,0,0,
G1200710020502,12,71,20502,45,177,222,0.2027027
G1200710020600,12,71,20600,50,57,107,0.46728972
G1200710020700,12,71,20700,51,167,218,0.23394495
G1200710020800,12,71,20800,19,48,67,0.28358209
G1200710030100,12,71,30100,14,146,160,0.087499999
G1200710030201,12,71,30201,0,28,28,0
G1200710030202,12,71,30202,14,301,315,0.044444446
G1200710030203,12,71,30203,16,103,119,0.13445379
G1200710030204,12,71,30204,16,47,63,0.25396827
G1200710030300,12,71,30300,10,162,172,0.058139537
G1200710040108,12,71,40108,7,272,279,0.025089607
G1200710040109,12,71,40109,213,320,533,0.39962476
G1200710040110,12,71,40110,4,186,190,0.021052632
G1200710040111,12,71,40111,0,0,0,
G1200710040112,12,71,40112,0,199,199,0
G1200710040113,12,71,40113,0,124,124,0
G1200710040114,12,71,40114,24,118,142,0.16901408
G1200710040115,12,71,40115,0,142,142,0
G1200710040116,12,71,40116,54,656,710,0.076056339
G1200710040117,12,71,40117,0,184,184,0
G1200710040118,12,71,40118,0,0,0,
G1200710040119,12,71,40119,0,78,78,0
G1200710040120,12,71,40120,0,62,62,0
G1200710040121,12,71,40121,227,284,511,0.44422701
G1200710040122,12,71,40122,367,388,755,0.48609272
G1200710040123,12,71,40123,102,216,318,0.32075471
G1200710040124,12,71,40124,174,601,775,0.22451612
G1200710040125,12,71,40125,111,134,245,0.45306122
G1200710040126,12,71,40126,135,253,388,0.34793815
G1200710040127,12,71,40127,130,333,463,0.28077754
G1200710040203,12,71,40203,223,712,935,0.23850267
G1200710040205,12,71,40205,123,609,732,0.16803278
G1200710040206,12,71,40206,14,94,108,0.12962963
G1200710040207,12,71,40207,29,266,295,0.098305084
G1200710040208,12,71,40208,100,137,237,0.42194092
G1200710040209,12,71,40209,119,235,354,0.33615819
G1200710040210,12,71,40210,36,244,280,0.12857144
G1200710040301,12,71,40301,203,691,894,0.22706935
G1200710040302,12,71,40302,158,307,465,0.33978495
G1200710040303,12,71,40303,258,635,893,0.28891379
G1200710040304,12,71,40304,194,183,377,0.51458883
G1200710040305,12,71,40305,75,209,284,0.26408452
G1200710040308,12,71,40308,162,351,513,0.31578946
G1200710040309,12,71,40309,94,542,636,0.14779875
G1200710040310,12,71,40310,84,254,338,0.24852072
G1200710040311,12,71,40311,50,143,193,0.25906736
G1200710040312,12,71,40312,21,207,228,0.092105262
G1200710040313,12,71,40313,20,136,156,0.12820514
G1200710040314,12,71,40314,67,180,247,0.27125505
G1200710050103,12,71,50103,84,38,122,0.6885246
G1200710050104,12,71,50104,0,68,68,0
G1200710050105,12,71,50105,0,109,109,0
G1200710050106,12,71,50106,18,187,205,0.087804876
G1200710050203,12,71,50203,0,144,144,0
G1200710050204,12,71,50204,8,196,204,0.039215688
G1200710050205,12,71,50205,28,98,126,0.22222222
G1200710050206,12,71,50206,24,316,340,0.070588239
G1200710050207,12,71,50207,4,103,107,0.037383176
G1200710050208,12,71,50208,61,265,326,0.18711656
G1200710050209,12,71,50209,133,723,856,0.15537383
G1200710050305,12,71,50305,0,0,0,
G1200710050306,12,71,50306,0,148,148,0
G1200710050307,12,71,50307,0,108,108,0
G1200710050308,12,71,50308,288,318,606,0.47524753
G1200710050310,12,71,50310,0,143,143,0
G1200710050311,12,71,50311,28,547,575,0.048695654
G1200710050312,12,71,50312,58,62,120,0.48333332
G1200710050313,12,71,50313,108,186,294,0.36734694
G1200710050314,12,71,50314,0,166,166,0
G1200710050400,12,71,50400,246,652,898,0.27394208
G1200710050500,12,71,50500,149,271,420,0.3547619
G1200710050601,12,71,50601,32,94,126,0.25396827
G1200710050602,12,71,50602,26,125,151,0.17218544
G1200710060101,12,71,60101,0,7,7,0
G1200710060102,12,71,60102,0,39,39,0
G1200710060201,12,71,60201,0,0,0,
G1200710060202,12,71,60202,0,9,9,0
G1200710060203,12,71,60203,22,39,61,0.36065573
G1200710060300,12,71,60300,0,0,0,
G1200710070101,12,71,70101,0,57,57,0
G1200710070102,12,71,70102,68,49,117,0.58119661
G1200710070200,12,71,70200,0,66,66,0
G1200710080100,12,71,80100,0,0,0,
G1200710080202,12,71,80202,0,55,55,0
G1200710080203,12,71,80203,0,50,50,0
G1200710080204,12,71,80204,10,99,109,0.091743119
G1200710080300,12,71,80300,20,48,68,0.29411766
G1200710090100,12,71,90100,0,8,8,0
G1200710980000,12,71,980000,0,0,0,
G1200710990000,12,71,990000,0,0,0,
G1200730000200,12,73,200,46,167,213,0.21596244
G1200730000301,12,73,301,0,70,70,0
G1200730000302,12,73,302,13,87,100,0.13
G1200730000303,12,73,303,53,327,380,0.13947369
G1200730000400,12,73,400,20,27,47,0.42553192
G1200730000500,12,73,500,0,0,0,
G1200730000600,12,73,600,136,123,259,0.52509654
G1200730000700,12,73,700,82,29,111,0.73873872
G1200730000800,12,73,800,14,132,146,0.09589041
G1200730000901,12,73,901,20,649,669,0.029895367
G1200730000903,12,73,903,19,76,95,0.2
G1200730000904,12,73,904,0,162,162,0
G1200730000905,12,73,905,9,129,138,0.065217391
G1200730001001,12,73,1001,185,103,288,0.6423611
G1200730001002,12,73,1002,41,119,160,0.25624999
G1200730001101,12,73,1101,150,59,209,0.71770334
G1200730001102,12,73,1102,179,134,313,0.57188499
G1200730001200,12,73,1200,73,17,90,0.81111109
G1200730001300,12,73,1300,0,0,0,
G1200730001401,12,73,1401,51,61,112,0.45535713
G1200730001402,12,73,1402,158,34,192,0.82291669
G1200730001500,12,73,1500,59,132,191,0.30890054
G1200730001601,12,73,1601,117,306,423,0.27659574
G1200730001602,12,73,1602,0,218,218,0
G1200730001700,12,73,1700,35,487,522,0.067049809
G1200730001801,12,73,1801,283,259,542,0.5221402
G1200730001802,12,73,1802,191,348,539,0.35435992
G1200730001901,12,73,1901,92,131,223,0.41255605
G1200730001902,12,73,1902,111,175,286,0.38811189
G1200730002003,12,73,2003,12,15,27,0.44444445
G1200730002004,12,73,2004,0,165,165,0
G1200730002005,12,73,2005,0,0,0,
G1200730002006,12,73,2006,34,68,102,0.33333334
G1200730002101,12,73,2101,32,132,164,0.19512194
G1200730002103,12,73,2103,8,19,27,0.2962963
G1200730002104,12,73,2104,90,65,155,0.58064514
G1200730002201,12,73,2201,142,210,352,0.40340909
G1200730002205,12,73,2205,44,518,562,0.078291818
G1200730002206,12,73,2206,0,304,304,0
G1200730002207,12,73,2207,0,176,176,0
G1200730002208,12,73,2208,52,493,545,0.095412843
G1200730002302,12,73,2302,66,291,357,0.18487395
G1200730002303,12,73,2303,53,254,307,0.17263843
G1200730002304,12,73,2304,90,189,279,0.32258064
G1200730002403,12,73,2403,20,297,317,0.063091479
G1200730002408,12,73,2408,0,825,825,0
G1200730002410,12,73,2410,77,642,719,0.10709319
G1200730002411,12,73,2411,22,145,167,0.13173653
G1200730002412,12,73,2412,58,1098,1156,0.050173011
G1200730002413,12,73,2413,0,355,355,0
G1200730002414,12,73,2414,0,421,421,0
G1200730002415,12,73,2415,0,442,442,0
G1200730002416,12,73,2416,0,260,260,0
G1200730002417,12,73,2417,63,1074,1137,0.05540897
G1200730002505,12,73,2505,36,261,297,0.12121212
G1200730002507,12,73,2507,5,299,304,0.016447369
G1200730002508,12,73,2508,118,1057,1175,0.10042553
G1200730002509,12,73,2509,88,316,404,0.21782178
G1200730002510,12,73,2510,17,467,484,0.035123967
G1200730002511,12,73,2511,18,94,112,0.16071428
G1200730002512,12,73,2512,13,368,381,0.034120735
G1200730002513,12,73,2513,0,595,595,0
G1200730002603,12,73,2603,49,345,394,0.12436548
G1200730002604,12,73,2604,8,222,230,0.034782607
G1200730002605,12,73,2605,13,480,493,0.026369167
G1200730002606,12,73,2606,0,338,338,0
G1200730002701,12,73,2701,110,305,415,0.26506025
G1200730002702,12,73,2702,83,311,394,0.21065989
G1200750970101,12,75,970101,97,90,187,0.51871657
G1200750970102,12,75,970102,77,471,548,0.14051095
G1200750970200,12,75,970200,176,207,383,0.45953003
G1200750970301,12,75,970301,0,88,88,0
G1200750970302,12,75,970302,182,337,519,0.35067436
G1200750970400,12,75,970400,68,165,233,0.2918455
G1200750970500,12,75,970500,122,435,557,0.21903051
G1200750970600,12,75,970600,120,310,430,0.27906978
G1200750970700,12,75,970700,68,118,186,0.36559141
G1200750990000,12,75,990000,0,0,0,
G1200770950100,12,77,950100,16,233,249,0.064257026
G1200770950200,12,77,950200,71,295,366,0.19398907
G1200790110100,12,79,110100,86,240,326,0.26380369
G1200790110200,12,79,110200,111,218,329,0.33738601
G1200790110301,12,79,110301,96,99,195,0.49230769
G1200790110302,12,79,110302,148,303,451,0.32815966
G1200790110400,12,79,110400,94,305,399,0.23558897
G1200810000101,12,81,101,12,30,42,0.2857143
G1200810000103,12,81,103,225,247,472,0.47669491
G1200810000105,12,81,105,270,102,372,0.72580647
G1200810000106,12,81,106,342,170,512,0.66796875
G1200810000201,12,81,201,18,53,71,0.25352111
G1200810000202,12,81,202,0,19,19,0
G1200810000304,12,81,304,138,129,267,0.51685393
G1200810000305,12,81,305,319,527,846,0.37706855
G1200810000306,12,81,306,301,191,492,0.61178863
G1200810000307,12,81,307,98,177,275,0.35636362
G1200810000308,12,81,308,56,189,245,0.22857143
G1200810000309,12,81,309,175,271,446,0.39237669
G1200810000310,12,81,310,161,257,418,0.38516745
G1200810000403,12,81,403,0,150,150,0
G1200810000405,12,81,405,0,159,159,0
G1200810000406,12,81,406,22,156,178,0.12359551
G1200810000407,12,81,407,26,138,164,0.15853658
G1200810000408,12,81,408,38,286,324,0.11728395
G1200810000501,12,81,501,51,272,323,0.15789473
G1200810000503,12,81,503,22,221,243,0.090534978
G1200810000504,12,81,504,81,299,380,0.21315789
G1200810000601,12,81,601,46,157,203,0.22660099
G1200810000603,12,81,603,41,238,279,0.1469534
G1200810000604,12,81,604,51,72,123,0.41463414
G1200810000703,12,81,703,58,125,183,0.31693989
G1200810000704,12,81,704,181,417,598,0.30267558
G1200810000705,12,81,705,284,428,712,0.3988764
G1200810000803,12,81,803,67,663,730,0.091780819
G1200810000804,12,81,804,22,304,326,0.067484662
G1200810000805,12,81,805,129,239,368,0.35054347
G1200810000807,12,81,807,44,433,477,0.092243187
G1200810000808,12,81,808,59,368,427,0.1381733
G1200810000809,12,81,809,12,303,315,0.03809524
G1200810000810,12,81,810,0,262,262,0
G1200810000901,12,81,901,54,244,298,0.18120806
G1200810000902,12,81,902,69,301,370,0.18648648
G1200810001000,12,81,1000,83,257,340,0.24411765
G1200810001104,12,81,1104,29,215,244,0.11885246
G1200810001105,12,81,1105,60,194,254,0.23622048
G1200810001106,12,81,1106,32,280,312,0.1025641
G1200810001107,12,81,1107,11,166,177,0.062146891
G1200810001108,12,81,1108,0,78,78,0
G1200810001202,12,81,1202,26,411,437,0.059496567
G1200810001203,12,81,1203,51,360,411,0.12408759
G1200810001204,12,81,1204,28,317,345,0.08115942
G1200810001300,12,81,1300,42,129,171,0.24561404
G1200810001402,12,81,1402,20,75,95,0.21052632
G1200810001403,12,81,1403,83,265,348,0.23850575
G1200810001404,12,81,1404,30,249,279,0.10752688
G1200810001501,12,81,1501,111,281,392,0.28316328
G1200810001502,12,81,1502,161,497,658,0.24468085
G1200810001601,12,81,1601,20,228,248,0.080645159
G1200810001602,12,81,1602,28,96,124,0.22580644
G1200810001701,12,81,1701,8,33,41,0.19512194
G1200810001703,12,81,1703,0,27,27,0
G1200810001704,12,81,1704,0,0,0,
G1200810001800,12,81,1800,106,89,195,0.54358977
G1200810001904,12,81,1904,28,121,149,0.18791947
G1200810001907,12,81,1907,124,490,614,0.20195439
G1200810001908,12,81,1908,19,248,267,0.071161047
G1200810001909,12,81,1909,0,104,104,0
G1200810001910,12,81,1910,14,383,397,0.035264485
G1200810001911,12,81,1911,40,513,553,0.072332732
G1200810001912,12,81,1912,0,423,423,0
G1200810001913,12,81,1913,0,362,362,0
G1200810001914,12,81,1914,84,173,257,0.32684824
G1200810002003,12,81,2003,18,373,391,0.046035804
G1200810002005,12,81,2005,0,302,302,0
G1200810002007,12,81,2007,18,414,432,0.041666668
G1200810002008,12,81,2008,28,547,575,0.048695654
G1200810002010,12,81,2010,56,188,244,0.22950819
G1200810002011,12,81,2011,67,341,408,0.16421568
G1200810002012,12,81,2012,0,306,306,0
G1200810002013,12,81,2013,60,1211,1271,0.047206923
G1200810002014,12,81,2014,28,436,464,0.060344826
G1200810002015,12,81,2015,40,802,842,0.047505938
G1200810002016,12,81,2016,171,430,601,0.28452578
G1200810002017,12,81,2017,57,435,492,0.11585366
G1200810990000,12,81,990000,0,0,0,
G1200830000100,12,83,100,200,239,439,0.45558086
G1200830000200,12,83,200,79,300,379,0.20844327
G1200830000301,12,83,301,55,299,354,0.15536723
G1200830000302,12,83,302,124,232,356,0.34831461
G1200830000401,12,83,401,27,124,151,0.17880794
G1200830000402,12,83,402,45,250,295,0.15254237
G1200830000501,12,83,501,9,78,87,0.10344828
G1200830000502,12,83,502,58,35,93,0.62365592
G1200830000601,12,83,601,105,131,236,0.44491526
G1200830000602,12,83,602,67,276,343,0.19533528
G1200830000604,12,83,604,196,285,481,0.40748441
G1200830000605,12,83,605,100,87,187,0.53475934
G1200830000701,12,83,701,287,141,428,0.67056078
G1200830000702,12,83,702,25,223,248,0.10080645
G1200830000801,12,83,801,0,126,126,0
G1200830000802,12,83,802,60,319,379,0.15831135
G1200830000901,12,83,901,138,310,448,0.3080357
G1200830000902,12,83,902,225,714,939,0.23961662
G1200830001003,12,83,1003,45,32,77,0.58441556
G1200830001004,12,83,1004,437,884,1321,0.33080998
G1200830001005,12,83,1005,65,420,485,0.13402061
G1200830001006,12,83,1006,68,579,647,0.10510046
G1200830001007,12,83,1007,0,171,171,0
G1200830001008,12,83,1008,0,104,104,0
G1200830001102,12,83,1102,46,174,220,0.2090909
G1200830001103,12,83,1103,72,473,545,0.13211009
G1200830001104,12,83,1104,98,254,352,0.27840909
G1200830001204,12,83,1204,350,547,897,0.39018953
G1200830001205,12,83,1205,70,212,282,0.24822696
G1200830001206,12,83,1206,56,147,203,0.27586207
G1200830001207,12,83,1207,497,714,1211,0.41040462
G1200830001208,12,83,1208,108,330,438,0.24657534
G1200830001301,12,83,1301,95,464,559,0.16994633
G1200830001302,12,83,1302,98,318,416,0.23557693
G1200830001401,12,83,1401,208,245,453,0.45916116
G1200830001402,12,83,1402,42,206,248,0.16935484
G1200830001500,12,83,1500,177,150,327,0.54128438
G1200830001600,12,83,1600,113,126,239,0.47280335
G1200830001700,12,83,1700,389,113,502,0.77490038
G1200830001800,12,83,1800,118,44,162,0.72839504
G1200830001900,12,83,1900,32,109,141,0.22695035
G1200830002001,12,83,2001,26,155,181,0.1436464
G1200830002002,12,83,2002,82,190,272,0.30147058
G1200830002100,12,83,2100,10,352,362,0.027624309
G1200830002201,12,83,2201,51,239,290,0.17586207
G1200830002202,12,83,2202,10,240,250,0.039999999
G1200830002203,12,83,2203,154,675,829,0.18576598
G1200830002301,12,83,2301,44,312,356,0.12359551
G1200830002302,12,83,2302,56,618,674,0.083086051
G1200830002401,12,83,2401,125,216,341,0.36656892
G1200830002402,12,83,2402,153,378,531,0.28813559
G1200830002502,12,83,2502,60,913,973,0.061664954
G1200830002503,12,83,2503,88,261,349,0.25214899
G1200830002504,12,83,2504,132,259,391,0.33759591
G1200830002601,12,83,2601,393,371,764,0.51439792
G1200830002602,12,83,2602,174,203,377,0.46153846
G1200830002604,12,83,2604,12,321,333,0.036036037
G1200830002605,12,83,2605,31,32,63,0.49206349
G1200830002606,12,83,2606,0,0,0,
G1200830002701,12,83,2701,292,255,547,0.53382087
G1200830002702,12,83,2702,74,289,363,0.20385675
G1200830980000,12,83,980000,0,0,0,
G1200830980100,12,83,980100,0,0,0,
G1200850000100,12,85,100,5,34,39,0.12820514
G1200850000200,12,85,200,40,181,221,0.18099548
G1200850000300,12,85,300,45,554,599,0.07512521
G1200850000400,12,85,400,72,554,626,0.11501598
G1200850000501,12,85,501,85,163,248,0.34274194
G1200850000502,12,85,502,0,221,221,0
G1200850000603,12,85,603,80,578,658,0.12158055
G1200850000604,12,85,604,19,494,513,0.037037037
G1200850000606,12,85,606,68,419,487,0.13963039
G1200850000607,12,85,607,8,52,60,0.13333334
G1200850000610,12,85,610,0,344,344,0
G1200850000700,12,85,700,0,100,100,0
G1200850000800,12,85,800,60,75,135,0.44444445
G1200850000901,12,85,901,0,51,51,0
G1200850000902,12,85,902,25,175,200,0.125
G1200850001000,12,85,1000,198,362,560,0.35357141
G1200850001102,12,85,1102,36,478,514,0.070038907
G1200850001103,12,85,1103,0,181,181,0
G1200850001104,12,85,1104,36,748,784,0.045918368
G1200850001200,12,85,1200,62,135,197,0.31472081
G1200850001301,12,85,1301,109,446,555,0.1963964
G1200850001302,12,85,1302,0,209,209,0
G1200850001404,12,85,1404,69,364,433,0.15935335
G1200850001406,12,85,1406,34,271,305,0.11147541
G1200850001407,12,85,1407,0,25,25,0
G1200850001408,12,85,1408,73,214,287,0.2543554
G1200850001409,12,85,1409,68,259,327,0.20795107
G1200850001410,12,85,1410,45,215,260,0.17307693
G1200850001500,12,85,1500,10,182,192,0.052083332
G1200850001601,12,85,1601,0,136,136,0
G1200850001602,12,85,1602,0,88,88,0
G1200850001700,12,85,1700,48,876,924,0.051948052
G1200850001801,12,85,1801,208,417,625,0.3328
G1200850001802,12,85,1802,231,98,329,0.70212764
G1200850990000,12,85,990000,0,0,0,
G1200850990100,12,85,990100,0,0,0,
G1200860000107,12,86,107,59,84,143,0.4125874
G1200860000109,12,86,109,82,203,285,0.28771931
G1200860000113,12,86,113,34,499,533,0.063789867
G1200860000115,12,86,115,8,167,175,0.045714285
G1200860000118,12,86,118,63,32,95,0.66315788
G1200860000119,12,86,119,70,372,442,0.15837105
G1200860000120,12,86,120,66,301,367,0.17983651
G1200860000121,12,86,121,0,115,115,0
G1200860000122,12,86,122,174,42,216,0.80555558
G1200860000123,12,86,123,11,217,228,0.048245613
G1200860000124,12,86,124,118,60,178,0.66292137
G1200860000125,12,86,125,55,192,247,0.22267206
G1200860000126,12,86,126,0,158,158,0
G1200860000127,12,86,127,28,219,247,0.11336032
G1200860000128,12,86,128,38,87,125,0.30399999
G1200860000129,12,86,129,0,11,11,0
G1200860000130,12,86,130,13,36,49,0.26530612
G1200860000131,12,86,131,0,223,223,0
G1200860000132,12,86,132,78,219,297,0.26262626
G1200860000133,12,86,133,0,764,764,0
G1200860000134,12,86,134,39,107,146,0.26712328
G1200860000140,12,86,140,45,279,324,0.1388889
G1200860000202,12,86,202,324,405,729,0.44444445
G1200860000204,12,86,204,196,368,564,0.34751773
G1200860000206,12,86,206,201,325,526,0.38212928
G1200860000209,12,86,209,343,391,734,0.46730244
G1200860000211,12,86,211,97,210,307,0.31596091
G1200860000212,12,86,212,247,242,489,0.50511247
G1200860000213,12,86,213,87,415,502,0.17330678
G1200860000214,12,86,214,75,343,418,0.17942584
G1200860000215,12,86,215,94,305,399,0.23558897
G1200860000216,12,86,216,85,409,494,0.17206478
G1200860000217,12,86,217,272,389,661,0.41149774
G1200860000218,12,86,218,200,256,456,0.43859649
G1200860000219,12,86,219,325,171,496,0.65524191
G1200860000220,12,86,220,167,270,437,0.38215104
G1200860000301,12,86,301,104,405,509,0.2043222
G1200860000302,12,86,302,0,230,230,0
G1200860000305,12,86,305,292,466,758,0.38522428
G1200860000306,12,86,306,171,242,413,0.41404358
G1200860000307,12,86,307,184,254,438,0.42009133
G1200860000308,12,86,308,85,372,457,0.18599562
G1200860000402,12,86,402,186,184,370,0.50270271
G1200860000403,12,86,403,240,240,480,0.5
G1200860000404,12,86,404,111,400,511,0.21722114
G1200860000405,12,86,405,144,287,431,0.33410674
G1200860000408,12,86,408,143,225,368,0.38858697
G1200860000409,12,86,409,178,321,499,0.35671341
G1200860000410,12,86,410,122,320,442,0.27601811
G1200860000411,12,86,411,248,367,615,0.40325204
G1200860000412,12,86,412,312,453,765,0.40784314
G1200860000413,12,86,413,111,338,449,0.24721603
G1200860000414,12,86,414,199,231,430,0.4627907
G1200860000501,12,86,501,385,413,798,0.48245615
G1200860000503,12,86,503,424,423,847,0.50059032
G1200860000504,12,86,504,216,322,538,0.40148699
G1200860000505,12,86,505,177,412,589,0.30050933
G1200860000601,12,86,601,111,275,386,0.28756475
G1200860000602,12,86,602,99,281,380,0.26052633
G1200860000603,12,86,603,131,289,420,0.31190476
G1200860000604,12,86,604,227,341,568,0.39964789
G1200860000605,12,86,605,194,226,420,0.46190476
G1200860000607,12,86,607,150,284,434,0.34562212
G1200860000608,12,86,608,229,149,378,0.60582012
G1200860000705,12,86,705,45,303,348,0.12931034
G1200860000706,12,86,706,176,478,654,0.26911315
G1200860000707,12,86,707,132,551,683,0.19326501
G1200860000708,12,86,708,172,434,606,0.28382838
G1200860000709,12,86,709,131,421,552,0.23731884
G1200860000710,12,86,710,81,291,372,0.21774194
G1200860000711,12,86,711,169,222,391,0.43222508
G1200860000712,12,86,712,87,184,271,0.32103321
G1200860000804,12,86,804,263,275,538,0.48884758
G1200860000805,12,86,805,100,312,412,0.24271844
G1200860000806,12,86,806,227,314,541,0.41959333
G1200860000807,12,86,807,161,212,373,0.43163538
G1200860000808,12,86,808,202,186,388,0.52061856
G1200860000901,12,86,901,169,388,557,0.30341113
G1200860000902,12,86,902,200,279,479,0.41753653
G1200860000903,12,86,903,97,136,233,0.416309
G1200860001002,12,86,1002,206,226,432,0.47685185
G1200860001003,12,86,1003,102,330,432,0.2361111
G1200860001004,12,86,1004,480,277,757,0.6340819
G1200860001005,12,86,1005,71,78,149,0.47651008
G1200860001006,12,86,1006,198,369,567,0.34920636
G1200860001101,12,86,1101,96,308,404,0.23762377
G1200860001102,12,86,1102,37,334,371,0.099730462
G1200860001103,12,86,1103,121,198,319,0.37931034
G1200860001104,12,86,1104,17,512,529,0.032136105
G1200860001203,12,86,1203,288,347,635,0.45354331
G1200860001204,12,86,1204,86,351,437,0.19679634
G1200860001205,12,86,1205,7,375,382,0.018324608
G1200860001206,12,86,1206,102,192,294,0.34693879
G1200860001301,12,86,1301,49,176,225,0.21777777
G1200860001302,12,86,1302,64,270,334,0.19161677
G1200860001401,12,86,1401,246,162,408,0.60294116
G1200860001402,12,86,1402,376,282,658,0.5714286
G1200860001501,12,86,1501,501,99,600,0.83499998
G1200860001502,12,86,1502,284,120,404,0.70297033
G1200860001602,12,86,1602,218,365,583,0.37392795
G1200860001603,12,86,1603,81,201,282,0.28723404
G1200860001605,12,86,1605,220,191,411,0.53527981
G1200860001606,12,86,1606,176,272,448,0.39285713
G1200860001701,12,86,1701,169,350,519,0.32562619
G1200860001702,12,86,1702,95,116,211,0.45023698
G1200860001703,12,86,1703,118,251,369,0.31978321
G1200860001801,12,86,1801,203,216,419,0.48448688
G1200860001802,12,86,1802,185,222,407,0.45454547
G1200860001803,12,86,1803,247,114,361,0.68421054
G1200860001901,12,86,1901,135,161,296,0.45608109
G1200860001903,12,86,1903,143,161,304,0.47039473
G1200860001904,12,86,1904,153,225,378,0.40476191
G1200860002001,12,86,2001,292,108,400,0.73000002
G1200860002003,12,86,2003,83,151,234,0.35470086
G1200860002004,12,86,2004,124,153,277,0.44765344
G1200860002100,12,86,2100,10,189,199,0.050251257
G1200860002201,12,86,2201,0,219,219,0
G1200860002202,12,86,2202,197,233,430,0.45813954
G1200860002300,12,86,2300,155,266,421,0.36817104
G1200860002402,12,86,2402,326,217,543,0.60036832
G1200860002403,12,86,2403,127,264,391,0.32480818
G1200860002404,12,86,2404,282,175,457,0.61706781
G1200860002501,12,86,2501,386,172,558,0.69175625
G1200860002502,12,86,2502,159,186,345,0.46086955
G1200860002600,12,86,2600,357,227,584,0.61130136
G1200860002702,12,86,2702,0,120,120,0
G1200860002703,12,86,2703,28,120,148,0.1891892
G1200860002705,12,86,2705,36,100,136,0.2647059
G1200860002706,12,86,2706,0,209,209,0
G1200860002800,12,86,2800,57,32,89,0.64044946
G1200860002900,12,86,2900,199,354,553,0.35985532
G1200860003001,12,86,3001,103,54,157,0.65605098
G1200860003003,12,86,3003,246,348,594,0.41414142
G1200860003004,12,86,3004,123,99,222,0.55405408
G1200860003100,12,86,3100,220,244,464,0.47413793
G1200860003400,12,86,3400,62,89,151,0.41059601
G1200860003601,12,86,3601,218,80,298,0.7315436
G1200860003602,12,86,3602,284,266,550,0.51636362
G1200860003702,12,86,3702,30,102,132,0.22727273
G1200860003703,12,86,3703,6,51,57,0.10526316
G1200860003704,12,86,3704,17,103,120,0.14166667
G1200860003705,12,86,3705,0,44,44,0
G1200860003706,12,86,3706,0,0,0,
G1200860003707,12,86,3707,0,45,45,0
G1200860003801,12,86,3801,158,481,639,0.24726135
G1200860003803,12,86,3803,13,168,181,0.071823202
G1200860003804,12,86,3804,33,437,470,0.070212767
G1200860003906,12,86,3906,22,405,427,0.051522247
G1200860003909,12,86,3909,18,43,61,0.29508197
G1200860003911,12,86,3911,192,173,365,0.52602738
G1200860003912,12,86,3912,31,324,355,0.087323941
G1200860003913,12,86,3913,73,381,454,0.16079295
G1200860003914,12,86,3914,229,98,327,0.70030582
G1200860003915,12,86,3915,219,391,610,0.35901639
G1200860003916,12,86,3916,52,219,271,0.19188192
G1200860003917,12,86,3917,45,281,326,0.1380368
G1200860003918,12,86,3918,49,92,141,0.34751773
G1200860003919,12,86,3919,18,147,165,0.10909091
G1200860003921,12,86,3921,0,166,166,0
G1200860003922,12,86,3922,68,231,299,0.22742476
G1200860004000,12,86,4000,68,422,490,0.13877551
G1200860004102,12,86,4102,24,76,100,0.23999999
G1200860004103,12,86,4103,32,197,229,0.13973799
G1200860004105,12,86,4105,18,27,45,0.40000001
G1200860004106,12,86,4106,59,254,313,0.18849841
G1200860004203,12,86,4203,0,47,47,0
G1200860004204,12,86,4204,0,46,46,0
G1200860004205,12,86,4205,10,132,142,0.070422538
G1200860004206,12,86,4206,0,56,56,0
G1200860004301,12,86,4301,0,18,18,0
G1200860004303,12,86,4303,154,14,168,0.91666669
G1200860004304,12,86,4304,19,80,99,0.19191919
G1200860004403,12,86,4403,17,63,80,0.21250001
G1200860004404,12,86,4404,52,9,61,0.85245901
G1200860004405,12,86,4405,108,50,158,0.68354428
G1200860004406,12,86,4406,0,61,61,0
G1200860004500,12,86,4500,0,159,159,0
G1200860004602,12,86,4602,23,528,551,0.041742288
G1200860004605,12,86,4605,61,395,456,0.13377193
G1200860004607,12,86,4607,0,328,328,0
G1200860004608,12,86,4608,32,193,225,0.14222223
G1200860004701,12,86,4701,46,508,554,0.083032489
G1200860004702,12,86,4702,117,481,598,0.19565217
G1200860004703,12,86,4703,140,351,491,0.28513238
G1200860004901,12,86,4901,183,210,393,0.46564886
G1200860004902,12,86,4902,147,358,505,0.29108912
G1200860005001,12,86,5001,101,332,433,0.23325635
G1200860005002,12,86,5002,189,178,367,0.5149864
G1200860005102,12,86,5102,19,110,129,0.14728682
G1200860005103,12,86,5103,77,151,228,0.33771929
G1200860005104,12,86,5104,303,70,373,0.81233245
G1200860005201,12,86,5201,193,328,521,0.37044147
G1200860005202,12,86,5202,136,259,395,0.34430379
G1200860005302,12,86,5302,364,105,469,0.77611941
G1200860005303,12,86,5303,241,196,437,0.55148739
G1200860005304,12,86,5304,273,233,506,0.53952569
G1200860005403,12,86,5403,40,120,160,0.25
G1200860005405,12,86,5405,94,162,256,0.3671875
G1200860005406,12,86,5406,279,69,348,0.80172414
G1200860005407,12,86,5407,52,138,190,0.2736842
G1200860005409,12,86,5409,99,133,232,0.42672414
G1200860005410,12,86,5410,88,154,242,0.36363637
G1200860005501,12,86,5501,70,230,300,0.23333333
G1200860005502,12,86,5502,264,140,404,0.65346533
G1200860005600,12,86,5600,80,346,426,0.18779343
G1200860005701,12,86,5701,196,314,510,0.38431373
G1200860005703,12,86,5703,66,480,546,0.12087912
G1200860005704,12,86,5704,264,574,838,0.31503579
G1200860005801,12,86,5801,114,519,633,0.18009479
G1200860005802,12,86,5802,318,329,647,0.49149922
G1200860005901,12,86,5901,89,263,352,0.25284091
G1200860005902,12,86,5902,172,147,319,0.53918493
G1200860005903,12,86,5903,150,360,510,0.29411766
G1200860005904,12,86,5904,0,280,280,0
G1200860006001,12,86,6001,0,457,457,0
G1200860006002,12,86,6002,59,406,465,0.12688172
G1200860006101,12,86,6101,0,447,447,0
G1200860006102,12,86,6102,0,343,343,0
G1200860006201,12,86,6201,51,89,140,0.36428571
G1200860006203,12,86,6203,0,94,94,0
G1200860006205,12,86,6205,49,131,180,0.27222222
G1200860006206,12,86,6206,45,108,153,0.29411766
G1200860006301,12,86,6301,286,279,565,0.50619471
G1200860006302,12,86,6302,74,259,333,0.22222222
G1200860006401,12,86,6401,160,251,411,0.38929442
G1200860006402,12,86,6402,47,230,277,0.1696751
G1200860006403,12,86,6403,152,162,314,0.48407644
G1200860006501,12,86,6501,118,249,367,0.32152587
G1200860006503,12,86,6503,112,149,261,0.42911878
G1200860006504,12,86,6504,50,164,214,0.23364486
G1200860006601,12,86,6601,103,376,479,0.21503131
G1200860006602,12,86,6602,197,222,419,0.47016707
G1200860006702,12,86,6702,25,512,537,0.046554934
G1200860006705,12,86,6705,0,169,169,0
G1200860006706,12,86,6706,0,131,131,0
G1200860006707,12,86,6707,47,451,498,0.09437751
G1200860006709,12,86,6709,0,35,35,0
G1200860006711,12,86,6711,14,97,111,0.12612613
G1200860006713,12,86,6713,126,75,201,0.62686568
G1200860006714,12,86,6714,56,58,114,0.49122807
G1200860006801,12,86,6801,42,166,208,0.20192307
G1200860006802,12,86,6802,0,294,294,0
G1200860006900,12,86,6900,40,385,425,0.094117649
G1200860007001,12,86,7001,200,603,803,0.249066
G1200860007002,12,86,7002,225,458,683,0.329429
G1200860007101,12,86,7101,58,86,144,0.40277779
G1200860007103,12,86,7103,5,81,86,0.058139537
G1200860007104,12,86,7104,46,111,157,0.29299363
G1200860007200,12,86,7200,118,122,240,0.49166667
G1200860007300,12,86,7300,21,355,376,0.055851065
G1200860007400,12,86,7400,0,512,512,0
G1200860007501,12,86,7501,34,216,250,0.13600001
G1200860007503,12,86,7503,0,74,74,0
G1200860007601,12,86,7601,53,285,338,0.15680474
G1200860007603,12,86,7603,8,213,221,0.036199097
G1200860007604,12,86,7604,38,434,472,0.080508478
G1200860007605,12,86,7605,28,314,342,0.081871346
G1200860007606,12,86,7606,87,553,640,0.1359375
G1200860007701,12,86,7701,16,464,480,0.033333335
G1200860007702,12,86,7702,43,443,486,0.088477366
G1200860007704,12,86,7704,48,302,350,0.13714285
G1200860007705,12,86,7705,15,339,354,0.042372882
G1200860007801,12,86,7801,13,116,129,0.1007752
G1200860007804,12,86,7804,24,398,422,0.056872036
G1200860007805,12,86,7805,24,360,384,0.0625
G1200860007806,12,86,7806,24,460,484,0.049586777
G1200860007807,12,86,7807,91,473,564,0.16134752
G1200860007901,12,86,7901,56,281,337,0.1661721
G1200860007902,12,86,7902,0,330,330,0
G1200860008000,12,86,8000,0,571,571,0
G1200860008101,12,86,8101,48,330,378,0.12698413
G1200860008102,12,86,8102,34,519,553,0.061482821
G1200860008202,12,86,8202,82,369,451,0.18181819
G1200860008205,12,86,8205,0,426,426,0
G1200860008206,12,86,8206,48,382,430,0.11162791
G1200860008207,12,86,8207,0,472,472,0
G1200860008208,12,86,8208,81,386,467,0.17344753
G1200860008209,12,86,8209,16,561,577,0.027729636
G1200860008304,12,86,8304,144,468,612,0.23529412
G1200860008305,12,86,8305,76,460,536,0.14179105
G1200860008306,12,86,8306,82,787,869,0.094361335
G1200860008307,12,86,8307,296,477,773,0.38292366
G1200860008308,12,86,8308,199,272,471,0.42250532
G1200860008309,12,86,8309,304,243,547,0.55575866
G1200860008405,12,86,8405,108,358,466,0.23175965
G1200860008407,12,86,8407,92,736,828,0.11111111
G1200860008409,12,86,8409,35,528,563,0.062166963
G1200860008410,12,86,8410,30,539,569,0.052724078
G1200860008412,12,86,8412,54,372,426,0.12676056
G1200860008414,12,86,8414,11,567,578,0.019031141
G1200860008415,12,86,8415,9,549,558,0.016129032
G1200860008416,12,86,8416,0,304,304,0
G1200860008417,12,86,8417,64,382,446,0.14349777
G1200860008418,12,86,8418,51,194,245,0.20816326
G1200860008419,12,86,8419,64,287,351,0.18233618
G1200860008501,12,86,8501,102,425,527,0.19354838
G1200860008502,12,86,8502,37,383,420,0.08809524
G1200860008601,12,86,8601,136,180,316,0.43037975
G1200860008602,12,86,8602,25,476,501,0.0499002
G1200860008701,12,86,8701,57,330,387,0.14728682
G1200860008702,12,86,8702,89,383,472,0.18855932
G1200860008803,12,86,8803,202,441,643,0.31415242
G1200860008804,12,86,8804,78,436,514,0.15175097
G1200860008805,12,86,8805,132,329,461,0.28633407
G1200860008806,12,86,8806,96,300,396,0.24242425
G1200860008901,12,86,8901,61,578,639,0.095461659
G1200860008902,12,86,8902,102,223,325,0.31384614
G1200860008904,12,86,8904,0,0,0,
G1200860008906,12,86,8906,135,295,430,0.31395349
G1200860008907,12,86,8907,13,290,303,0.042904291
G1200860009006,12,86,9006,67,572,639,0.10485133
G1200860009010,12,86,9010,20,515,535,0.037383176
G1200860009014,12,86,9014,105,321,426,0.24647887
G1200860009015,12,86,9015,148,415,563,0.26287743
G1200860009017,12,86,9017,172,416,588,0.29251701
G1200860009019,12,86,9019,8,225,233,0.034334764
G1200860009020,12,86,9020,71,122,193,0.36787564
G1200860009021,12,86,9021,225,300,525,0.42857143
G1200860009022,12,86,9022,33,158,191,0.17277487
G1200860009023,12,86,9023,233,382,615,0.37886178
G1200860009024,12,86,9024,106,349,455,0.23296703
G1200860009026,12,86,9026,100,175,275,0.36363637
G1200860009027,12,86,9027,129,278,407,0.31695333
G1200860009028,12,86,9028,89,321,410,0.21707317
G1200860009029,12,86,9029,27,286,313,0.08626198
G1200860009030,12,86,9030,55,234,289,0.19031142
G1200860009031,12,86,9031,98,231,329,0.29787233
G1200860009034,12,86,9034,116,858,974,0.11909651
G1200860009035,12,86,9035,0,414,414,0
G1200860009036,12,86,9036,200,906,1106,0.18083182
G1200860009038,12,86,9038,192,1032,1224,0.15686275
G1200860009039,12,86,9039,123,619,742,0.16576819
G1200860009040,12,86,9040,0,14,14,0
G1200860009043,12,86,9043,117,627,744,0.15725806
G1200860009044,12,86,9044,198,180,378,0.52380955
G1200860009046,12,86,9046,32,109,141,0.22695035
G1200860009047,12,86,9047,92,362,454,0.20264317
G1200860009100,12,86,9100,156,245,401,0.38902742
G1200860009200,12,86,9200,54,182,236,0.22881356
G1200860009305,12,86,9305,14,452,466,0.030042918
G1200860009306,12,86,9306,137,337,474,0.28902954
G1200860009307,12,86,9307,325,446,771,0.42153049
G1200860009308,12,86,9308,510,247,757,0.67371202
G1200860009309,12,86,9309,62,496,558,0.11111111
G1200860009311,12,86,9311,193,381,574,0.33623692
G1200860009312,12,86,9312,20,270,290,0.068965517
G1200860009313,12,86,9313,30,449,479,0.062630482
G1200860009314,12,86,9314,207,195,402,0.51492536
G1200860009315,12,86,9315,61,263,324,0.18827161
G1200860009400,12,86,9400,204,392,596,0.34228188
G1200860009501,12,86,9501,132,447,579,0.22797927
G1200860009503,12,86,9503,147,376,523,0.28107074
G1200860009504,12,86,9504,172,318,490,0.3510204
G1200860009600,12,86,9600,216,726,942,0.22929937
G1200860009703,12,86,9703,20,334,354,0.056497175
G1200860009704,12,86,9704,25,585,610,0.040983606
G1200860009705,12,86,9705,122,194,316,0.38607594
G1200860009706,12,86,9706,46,386,432,0.10648149
G1200860009803,12,86,9803,29,455,484,0.059917357
G1200860009804,12,86,9804,64,274,338,0.18934911
G1200860009806,12,86,9806,46,203,249,0.18473895
G1200860009807,12,86,9807,83,469,552,0.15036231
G1200860009808,12,86,9808,18,236,254,0.070866145
G1200860009901,12,86,9901,159,842,1001,0.15884116
G1200860009903,12,86,9903,66,394,460,0.14347826
G1200860009904,12,86,9904,155,224,379,0.40897098
G1200860009905,12,86,9905,105,413,518,0.2027027
G1200860009906,12,86,9906,110,354,464,0.23706897
G1200860010001,12,86,10001,258,359,617,0.41815236
G1200860010005,12,86,10005,222,467,689,0.32220611
G1200860010006,12,86,10006,134,697,831,0.1612515
G1200860010009,12,86,10009,367,397,764,0.4803665
G1200860010010,12,86,10010,142,303,445,0.31910113
G1200860010011,12,86,10011,157,421,578,0.27162629
G1200860010012,12,86,10012,128,305,433,0.29561201
G1200860010013,12,86,10013,249,322,571,0.43607706
G1200860010015,12,86,10015,139,243,382,0.36387435
G1200860010016,12,86,10016,110,363,473,0.23255815
G1200860010193,12,86,10193,39,316,355,0.10985915
G1200860010198,12,86,10198,5,358,363,0.013774104
G1200860010201,12,86,10201,74,442,516,0.14341085
G1200860010204,12,86,10204,65,653,718,0.090529248
G1200860010205,12,86,10205,193,269,462,0.41774893
G1200860010207,12,86,10207,97,258,355,0.27323943
G1200860010208,12,86,10208,208,360,568,0.36619717
G1200860010209,12,86,10209,223,380,603,0.36981758
G1200860010210,12,86,10210,147,407,554,0.26534295
G1200860010300,12,86,10300,157,519,676,0.23224851
G1200860010400,12,86,10400,106,206,312,0.33974358
G1200860010500,12,86,10500,358,1052,1410,0.25390071
G1200860010604,12,86,10604,93,360,453,0.20529801
G1200860010606,12,86,10606,10,597,607,0.016474465
G1200860010608,12,86,10608,94,412,506,0.18577075
G1200860010609,12,86,10609,156,391,547,0.28519195
G1200860010610,12,86,10610,91,347,438,0.20776255
G1200860010612,12,86,10612,170,1087,1257,0.13524264
G1200860010613,12,86,10613,102,506,608,0.16776316
G1200860010614,12,86,10614,410,811,1221,0.33579034
G1200860010617,12,86,10617,113,691,804,0.14054726
G1200860010703,12,86,10703,784,812,1596,0.49122807
G1200860010704,12,86,10704,441,817,1258,0.35055643
G1200860010801,12,86,10801,417,387,804,0.51865673
G1200860010802,12,86,10802,459,442,901,0.50943398
G1200860010900,12,86,10900,356,306,662,0.53776437
G1200860011001,12,86,11001,781,536,1317,0.59301442
G1200860011003,12,86,11003,168,255,423,0.39716312
G1200860011005,12,86,11005,251,402,653,0.38437977
G1200860011007,12,86,11007,69,629,698,0.098853871
G1200860011008,12,86,11008,0,548,548,0
G1200860011009,12,86,11009,191,663,854,0.22365339
G1200860011101,12,86,11101,511,552,1063,0.48071495
G1200860011102,12,86,11102,69,678,747,0.092369474
G1200860011201,12,86,11201,344,439,783,0.43933588
G1200860011202,12,86,11202,210,469,679,0.30927834
G1200860011300,12,86,11300,663,319,982,0.67515278
G1200860011401,12,86,11401,541,1658,2199,0.24602091
G1200860011403,12,86,11403,499,298,797,0.62609786
G1200860011404,12,86,11404,329,322,651,0.50537634
G1200860011500,12,86,11500,99,545,644,0.15372671
G1200860011600,12,86,11600,22,623,645,0.034108527
G1200860011700,12,86,11700,174,693,867,0.20069204
G1200860011800,12,86,11800,60,209,269,0.22304833
G1200860011900,12,86,11900,45,481,526,0.085551329
G1200860012000,12,86,12000,443,583,1026,0.43177387
G1200860012100,12,86,12100,646,1232,1878,0.34398296
G1200860012200,12,86,12200,31,486,517,0.059961315
G1200860012300,12,86,12300,95,648,743,0.12786002
G1200860012400,12,86,12400,153,1213,1366,0.11200586
G1200860012500,12,86,12500,42,577,619,0.067851372
G1200860012600,12,86,12600,274,560,834,0.32853717
G1200860012700,12,86,12700,110,842,952,0.11554622
G1200860012800,12,86,12800,158,843,1001,0.15784216
G1200860012900,12,86,12900,70,326,396,0.17676768
G1200860013000,12,86,13000,165,359,524,0.3148855
G1200860013100,12,86,13100,305,407,712,0.42837077
G1200860013200,12,86,13200,130,446,576,0.22569445
G1200860013300,12,86,13300,235,442,677,0.34711966
G1200860013400,12,86,13400,114,458,572,0.19930071
G1200860013500,12,86,13500,244,411,655,0.37251908
G1200860013600,12,86,13600,311,289,600,0.51833332
G1200860013700,12,86,13700,229,462,691,0.33140376
G1200860013800,12,86,13800,147,309,456,0.32236841
G1200860013900,12,86,13900,24,316,340,0.070588239
G1200860014000,12,86,14000,11,18,29,0.37931034
G1200860014100,12,86,14100,0,0,0,
G1200860014200,12,86,14200,143,442,585,0.24444444
G1200860014300,12,86,14300,0,272,272,0
G1200860014400,12,86,14400,90,345,435,0.20689656
G1200860014500,12,86,14500,69,322,391,0.17647059
G1200860014600,12,86,14600,181,482,663,0.27300152
G1200860014700,12,86,14700,198,482,680,0.29117647
G1200860014800,12,86,14800,103,325,428,0.2406542
G1200860014900,12,86,14900,25,403,428,0.058411215
G1200860015000,12,86,15000,262,583,845,0.31005916
G1200860015100,12,86,15100,13,1111,1124,0.011565836
G1200860015200,12,86,15200,64,621,685,0.093430653
G1200860015300,12,86,15300,133,395,528,0.25189394
G1200860015400,12,86,15400,79,361,440,0.17954545
G1200860015500,12,86,15500,54,393,447,0.12080537
G1200860015600,12,86,15600,43,237,280,0.15357143
G1200860015700,12,86,15700,34,174,208,0.16346154
G1200860015800,12,86,15800,86,259,345,0.24927536
G1200860015900,12,86,15900,152,229,381,0.39895013
G1200860016000,12,86,16000,22,381,403,0.054590572
G1200860016100,12,86,16100,122,358,480,0.25416666
G1200860016200,12,86,16200,51,254,305,0.16721311
G1200860016300,12,86,16300,55,527,582,0.094501719
G1200860016400,12,86,16400,119,568,687,0.17321688
G1200860016500,12,86,16500,146,897,1043,0.13998082
G1200860016600,12,86,16600,108,221,329,0.32826748
G1200860016700,12,86,16700,122,404,526,0.23193917
G1200860016800,12,86,16800,35,342,377,0.092838198
G1200860016900,12,86,16900,113,447,560,0.20178571
G1200860017000,12,86,17000,175,438,613,0.28548124
G1200860017100,12,86,17100,199,431,630,0.31587303
G1200860017200,12,86,17200,10,351,361,0.02770083
G1200860017300,12,86,17300,80,296,376,0.21276596
G1200860017400,12,86,17400,206,388,594,0.34680134
G1200860017500,12,86,17500,127,273,400,0.3175
G1200860017600,12,86,17600,93,580,673,0.13818721
G1200860017700,12,86,17700,155,285,440,0.35227272
G1200860017800,12,86,17800,344,530,874,0.39359269
G1200860017900,12,86,17900,114,653,767,0.14863104
G1200860018000,12,86,18000,119,692,811,0.14673243
G1200860018100,12,86,18100,34,417,451,0.075388029
G1200860018200,12,86,18200,70,275,345,0.20289855
G1200860018300,12,86,18300,50,467,517,0.0967118
G1200860018400,12,86,18400,145,315,460,0.31521741
G1200860018500,12,86,18500,82,397,479,0.17118998
G1200860018600,12,86,18600,32,870,902,0.035476718
G1200860018700,12,86,18700,36,340,376,0.095744684
G1200860018800,12,86,18800,157,532,689,0.22786647
G1200860018900,12,86,18900,131,567,698,0.18767908
G1200860019000,12,86,19000,101,491,592,0.1706081
G1200860019100,12,86,19100,13,315,328,0.039634146
G1200860019200,12,86,19200,109,548,657,0.16590562
G1200860019300,12,86,19300,110,653,763,0.14416777
G1200860019400,12,86,19400,162,772,934,0.17344753
G1200860019500,12,86,19500,167,737,904,0.18473451
G1200860019600,12,86,19600,69,574,643,0.10730949
G1200860019700,12,86,19700,0,406,406,0
G1200860019800,12,86,19800,156,998,1154,0.13518198
G1200860019900,12,86,19900,80,1163,1243,0.064360417
G1200860020000,12,86,20000,150,615,765,0.19607843
G1200860020100,12,86,20100,0,395,395,0
G1200860020200,12,86,20200,77,352,429,0.17948718
G1200860020300,12,86,20300,82,316,398,0.20603015
G1200860490100,12,86,490100,85,73,158,0.53797466
G1200860980100,12,86,980100,0,0,0,
G1200860980200,12,86,980200,0,0,0,
G1200860980300,12,86,980300,0,8,8,0
G1200860980400,12,86,980400,0,0,0,
G1200860980500,12,86,980500,0,0,0,
G1200860980600,12,86,980600,0,0,0,
G1200860980700,12,86,980700,62,0,62,1
G1200860980800,12,86,980800,0,0,0,
G1200860980900,12,86,980900,0,0,0,
G1200860981000,12,86,981000,0,0,0,
G1200860990000,12,86,990000,0,0,0,
G1200870970200,12,87,970200,0,21,21,0
G1200870970300,12,87,970300,18,107,125,0.14399999
G1200870970400,12,87,970400,72,226,298,0.24161074
G1200870970500,12,87,970500,0,176,176,0
G1200870970600,12,87,970600,8,67,75,0.10666667
G1200870970700,12,87,970700,35,150,185,0.1891892
G1200870970800,12,87,970800,18,252,270,0.06666667
G1200870970900,12,87,970900,10,67,77,0.12987013
G1200870971001,12,87,971001,0,8,8,0
G1200870971002,12,87,971002,24,29,53,0.4528302
G1200870971100,12,87,971100,111,167,278,0.39928058
G1200870971200,12,87,971200,30,19,49,0.6122449
G1200870971300,12,87,971300,30,43,73,0.41095892
G1200870971401,12,87,971401,74,72,146,0.50684929
G1200870971402,12,87,971402,0,39,39,0
G1200870971501,12,87,971501,29,54,83,0.3493976
G1200870971502,12,87,971502,27,127,154,0.17532468
G1200870971600,12,87,971600,7,121,128,0.0546875
G1200870971700,12,87,971700,0,140,140,0
G1200870971800,12,87,971800,54,271,325,0.16615385
G1200870971900,12,87,971900,43,392,435,0.098850578
G1200870972000,12,87,972000,16,159,175,0.09142857
G1200870972100,12,87,972100,16,274,290,0.055172414
G1200870972200,12,87,972200,52,143,195,0.26666668
G1200870972300,12,87,972300,0,19,19,0
G1200870972400,12,87,972400,106,92,198,0.53535354
G1200870972500,12,87,972500,16,16,32,0.5
G1200870972600,12,87,972600,0,55,55,0
G1200870980000,12,87,980000,0,0,0,
G1200870980100,12,87,980100,0,0,0,
G1200870990000,12,87,990000,0,0,0,
G1200890050101,12,89,50101,177,213,390,0.45384616
G1200890050102,12,89,50102,0,259,259,0
G1200890050201,12,89,50201,0,24,24,0
G1200890050202,12,89,50202,43,355,398,0.1080402
G1200890050203,12,89,50203,9,184,193,0.046632126
G1200890050301,12,89,50301,29,860,889,0.032620922
G1200890050302,12,89,50302,134,506,640,0.20937499
G1200890050303,12,89,50303,549,844,1393,0.39411342
G1200890050400,12,89,50400,255,721,976,0.26127049
G1200890050502,12,89,50502,69,659,728,0.094780222
G1200890050503,12,89,50503,131,508,639,0.20500782
G1200890050504,12,89,50504,91,357,448,0.203125
G1200890990000,12,89,990000,0,0,0,
G1200910020100,12,91,20100,67,727,794,0.084382869
G1200910020200,12,91,20200,37,115,152,0.24342105
G1200910020301,12,91,20301,156,723,879,0.17747441
G1200910020302,12,91,20302,101,495,596,0.16946308
G1200910020400,12,91,20400,180,411,591,0.30456853
G1200910020500,12,91,20500,305,505,810,0.37654322
G1200910020600,12,91,20600,141,1143,1284,0.10981309
G1200910020700,12,91,20700,232,766,998,0.23246492
G1200910020800,12,91,20800,11,468,479,0.022964509
G1200910020900,12,91,20900,27,535,562,0.048042703
G1200910021001,12,91,21001,58,513,571,0.10157618
G1200910021002,12,91,21002,20,505,525,0.03809524
G1200910021101,12,91,21101,17,164,181,0.093922652
G1200910021102,12,91,21102,219,580,799,0.27409261
G1200910021200,12,91,21200,210,250,460,0.45652175
G1200910021400,12,91,21400,27,160,187,0.14438502
G1200910021501,12,91,21501,34,389,423,0.080378249
G1200910021502,12,91,21502,77,304,381,0.20209974
G1200910021600,12,91,21600,4,136,140,0.028571429
G1200910021700,12,91,21700,58,281,339,0.17109145
G1200910021801,12,91,21801,148,357,505,0.2930693
G1200910021802,12,91,21802,47,177,224,0.20982143
G1200910021900,12,91,21900,228,583,811,0.2811344
G1200910022001,12,91,22001,86,263,349,0.24641834
G1200910022002,12,91,22002,135,191,326,0.41411042
G1200910022100,12,91,22100,49,296,345,0.14202899
G1200910022300,12,91,22300,28,137,165,0.16969697
G1200910022400,12,91,22400,36,240,276,0.13043478
G1200910022500,12,91,22500,103,220,323,0.31888545
G1200910022600,12,91,22600,87,130,217,0.40092167
G1200910022700,12,91,22700,94,211,305,0.30819672
G1200910022800,12,91,22800,87,97,184,0.47282609
G1200910022900,12,91,22900,63,326,389,0.16195373
G1200910023100,12,91,23100,111,605,716,0.15502793
G1200910023200,12,91,23200,0,102,102,0
G1200910023303,12,91,23303,68,16,84,0.80952382
G1200910023304,12,91,23304,0,319,319,0
G1200910023305,12,91,23305,0,359,359,0
G1200910023306,12,91,23306,63,154,217,0.29032257
G1200910023307,12,91,23307,25,94,119,0.21008404
G1200910023308,12,91,23308,0,212,212,0
G1200910990100,12,91,990100,0,0,0,
G1200910990200,12,91,990200,0,0,0,
G1200930910101,12,93,910101,131,187,318,0.41194969
G1200930910102,12,93,910102,45,174,219,0.20547946
G1200930910201,12,93,910201,166,236,402,0.41293532
G1200930910202,12,93,910202,316,311,627,0.50398725
G1200930910300,12,93,910300,72,44,116,0.62068963
G1200930910401,12,93,910401,43,180,223,0.19282511
G1200930910402,12,93,910402,157,141,298,0.52684563
G1200930910403,12,93,910403,102,59,161,0.63354039
G1200930910500,12,93,910500,92,348,440,0.2090909
G1200930910601,12,93,910601,36,415,451,0.079822615
G1200930910602,12,93,910602,10,105,115,0.086956523
G1200930990000,12,93,990000,0,0,0,
G1200950010200,12,95,10200,34,35,69,0.49275362
G1200950010300,12,95,10300,7,85,92,0.076086953
G1200950010400,12,95,10400,52,78,130,0.40000001
G1200950010500,12,95,10500,52,50,102,0.50980395
G1200950010802,12,95,10802,33,136,169,0.19526628
G1200950011000,12,95,11000,80,46,126,0.63492066
G1200950011100,12,95,11100,19,141,160,0.11875
G1200950011200,12,95,11200,43,114,157,0.27388534
G1200950011300,12,95,11300,40,302,342,0.11695907
G1200950011600,12,95,11600,177,162,339,0.52212387
G1200950011701,12,95,11701,185,142,327,0.56574923
G1200950011702,12,95,11702,157,148,305,0.51475412
G1200950012000,12,95,12000,400,463,863,0.46349943
G1200950012100,12,95,12100,324,405,729,0.44444445
G1200950012201,12,95,12201,133,297,430,0.30930233
G1200950012202,12,95,12202,168,333,501,0.33532935
G1200950012303,12,95,12303,156,653,809,0.19283065
G1200950012304,12,95,12304,307,454,761,0.40341654
G1200950012305,12,95,12305,515,420,935,0.55080211
G1200950012306,12,95,12306,54,243,297,0.18181819
G1200950012307,12,95,12307,118,359,477,0.24737945
G1200950012401,12,95,12401,376,601,977,0.38485157
G1200950012402,12,95,12402,98,535,633,0.15481833
G1200950012403,12,95,12403,141,476,617,0.22852512
G1200950012500,12,95,12500,10,125,135,0.074074075
G1200950012600,12,95,12600,21,337,358,0.058659218
G1200950012701,12,95,12701,32,353,385,0.083116882
G1200950012800,12,95,12800,0,301,301,0
G1200950012900,12,95,12900,52,124,176,0.29545453
G1200950013201,12,95,13201,68,260,328,0.20731707
G1200950013202,12,95,13202,132,363,495,0.26666668
G1200950013300,12,95,13300,240,264,504,0.47619048
G1200950013402,12,95,13402,19,294,313,0.060702875
G1200950013403,12,95,13403,104,284,388,0.26804122
G1200950013405,12,95,13405,72,169,241,0.2987552
G1200950013406,12,95,13406,115,179,294,0.39115646
G1200950013503,12,95,13503,148,100,248,0.59677422
G1200950013505,12,95,13505,133,189,322,0.41304347
G1200950013507,12,95,13507,421,474,895,0.47039106
G1200950013508,12,95,13508,165,75,240,0.6875
G1200950013509,12,95,13509,17,60,77,0.22077923
G1200950013510,12,95,13510,44,21,65,0.6769231
G1200950013511,12,95,13511,125,261,386,0.32383421
G1200950013512,12,95,13512,269,389,658,0.40881458
G1200950013603,12,95,13603,81,313,394,0.20558375
G1200950013604,12,95,13604,326,295,621,0.52495974
G1200950013605,12,95,13605,60,320,380,0.15789473
G1200950013606,12,95,13606,124,273,397,0.31234258
G1200950013607,12,95,13607,85,391,476,0.17857143
G1200950013701,12,95,13701,86,265,351,0.24501425
G1200950013702,12,95,13702,118,454,572,0.2062937
G1200950013801,12,95,13801,23,180,203,0.11330049
G1200950013802,12,95,13802,75,190,265,0.28301886
G1200950013803,12,95,13803,20,204,224,0.089285716
G1200950013900,12,95,13900,16,237,253,0.063241109
G1200950014000,12,95,14000,106,420,526,0.20152092
G1200950014100,12,95,14100,20,465,485,0.041237112
G1200950014200,12,95,14200,403,478,881,0.45743474
G1200950014301,12,95,14301,102,289,391,0.26086956
G1200950014302,12,95,14302,99,442,541,0.18299446
G1200950014400,12,95,14400,101,134,235,0.42978725
G1200950014502,12,95,14502,282,201,483,0.58385092
G1200950014503,12,95,14503,150,139,289,0.51903117
G1200950014504,12,95,14504,0,170,170,0
G1200950014601,12,95,14601,420,470,890,0.47191012
G1200950014605,12,95,14605,131,266,397,0.3299748
G1200950014606,12,95,14606,268,435,703,0.38122332
G1200950014607,12,95,14607,56,416,472,0.11864407
G1200950014608,12,95,14608,175,283,458,0.38209608
G1200950014609,12,95,14609,115,371,486,0.23662551
G1200950014701,12,95,14701,150,534,684,0.21929824
G1200950014702,12,95,14702,85,315,400,0.21250001
G1200950014703,12,95,14703,41,174,215,0.19069767
G1200950014704,12,95,14704,278,1016,1294,0.21483772
G1200950014804,12,95,14804,262,478,740,0.35405406
G1200950014805,12,95,14805,103,430,533,0.19324578
G1200950014806,12,95,14806,13,475,488,0.026639344
G1200950014807,12,95,14807,66,590,656,0.10060976
G1200950014808,12,95,14808,133,1387,1520,0.087499999
G1200950014809,12,95,14809,9,256,265,0.033962265
G1200950014810,12,95,14810,81,500,581,0.1394148
G1200950014811,12,95,14811,0,447,447,0
G1200950014812,12,95,14812,109,556,665,0.16390978
G1200950014813,12,95,14813,119,301,420,0.28333333
G1200950014904,12,95,14904,193,612,805,0.23975155
G1200950014906,12,95,14906,70,609,679,0.10309278
G1200950014908,12,95,14908,74,412,486,0.15226337
G1200950014909,12,95,14909,127,267,394,0.32233503
G1200950015001,12,95,15001,54,142,196,0.27551019
G1200950015002,12,95,15002,188,367,555,0.33873874
G1200950015003,12,95,15003,143,393,536,0.26679105
G1200950015004,12,95,15004,64,1017,1081,0.059204441
G1200950015103,12,95,15103,163,472,635,0.25669292
G1200950015104,12,95,15104,138,397,535,0.25794393
G1200950015105,12,95,15105,144,302,446,0.32286996
G1200950015106,12,95,15106,225,696,921,0.24429968
G1200950015201,12,95,15201,153,488,641,0.23868954
G1200950015202,12,95,15202,221,316,537,0.41154563
G1200950015300,12,95,15300,44,139,183,0.24043716
G1200950015402,12,95,15402,26,86,112,0.23214285
G1200950015501,12,95,15501,39,353,392,0.099489793
G1200950015601,12,95,15601,0,282,282,0
G1200950015602,12,95,15602,24,319,343,0.069970846
G1200950015701,12,95,15701,0,140,140,0
G1200950015702,12,95,15702,13,187,200,0.064999998
G1200950015801,12,95,15801,0,132,132,0
G1200950015802,12,95,15802,0,272,272,0
G1200950015901,12,95,15901,64,97,161,0.39751554
G1200950015902,12,95,15902,0,41,41,0
G1200950016001,12,95,16001,0,61,61,0
G1200950016002,12,95,16002,0,238,238,0
G1200950016100,12,95,16100,13,344,357,0.036414567
G1200950016200,12,95,16200,0,452,452,0
G1200950016301,12,95,16301,39,499,538,0.072490707
G1200950016302,12,95,16302,125,252,377,0.33156499
G1200950016402,12,95,16402,64,183,247,0.25910932
G1200950016406,12,95,16406,6,82,88,0.06818182
G1200950016407,12,95,16407,101,149,250,0.40400001
G1200950016408,12,95,16408,22,178,200,0.11
G1200950016409,12,95,16409,38,239,277,0.13718411
G1200950016410,12,95,16410,136,541,677,0.20088626
G1200950016411,12,95,16411,37,189,226,0.16371681
G1200950016412,12,95,16412,25,260,285,0.087719299
G1200950016503,12,95,16503,0,261,261,0
G1200950016504,12,95,16504,140,219,359,0.38997215
G1200950016505,12,95,16505,110,100,210,0.52380955
G1200950016507,12,95,16507,47,553,600,0.078333333
G1200950016508,12,95,16508,172,494,666,0.25825825
G1200950016509,12,95,16509,58,237,295,0.19661017
G1200950016510,12,95,16510,34,19,53,0.64150941
G1200950016511,12,95,16511,93,89,182,0.51098901
G1200950016601,12,95,16601,168,874,1042,0.1612284
G1200950016602,12,95,16602,408,674,1082,0.37707949
G1200950016704,12,95,16704,70,2321,2391,0.029276453
G1200950016709,12,95,16709,249,524,773,0.32212159
G1200950016710,12,95,16710,110,330,440,0.25
G1200950016712,12,95,16712,271,495,766,0.3537859
G1200950016713,12,95,16713,264,514,778,0.33933163
G1200950016714,12,95,16714,80,326,406,0.19704433
G1200950016715,12,95,16715,149,284,433,0.34411085
G1200950016716,12,95,16716,29,462,491,0.059063137
G1200950016717,12,95,16717,38,264,302,0.12582782
G1200950016723,12,95,16723,92,346,438,0.21004567
G1200950016724,12,95,16724,219,503,722,0.3033241
G1200950016727,12,95,16727,358,426,784,0.45663264
G1200950016728,12,95,16728,45,390,435,0.10344828
G1200950016729,12,95,16729,746,1368,2114,0.35288551
G1200950016730,12,95,16730,469,3256,3725,0.12590604
G1200950016731,12,95,16731,0,453,453,0
G1200950016732,12,95,16732,98,1585,1683,0.058229353
G1200950016733,12,95,16733,0,550,550,0
G1200950016734,12,95,16734,329,896,1225,0.26857144
G1200950016802,12,95,16802,0,715,715,0
G1200950016803,12,95,16803,58,137,195,0.29743591
G1200950016804,12,95,16804,22,316,338,0.065088756
G1200950016806,12,95,16806,198,830,1028,0.192607
G1200950016807,12,95,16807,860,1890,2750,0.31272727
G1200950016902,12,95,16902,158,306,464,0.34051725
G1200950016903,12,95,16903,521,956,1477,0.35274205
G1200950016904,12,95,16904,61,236,297,0.2053872
G1200950016906,12,95,16906,107,172,279,0.38351256
G1200950016907,12,95,16907,402,111,513,0.78362572
G1200950017001,12,95,17001,60,178,238,0.25210086
G1200950017004,12,95,17004,45,194,239,0.18828452
G1200950017006,12,95,17006,76,284,360,0.21111111
G1200950017008,12,95,17008,158,1104,1262,0.1251981
G1200950017011,12,95,17011,72,421,493,0.14604463
G1200950017012,12,95,17012,25,274,299,0.08361204
G1200950017013,12,95,17013,288,515,803,0.35865504
G1200950017014,12,95,17014,452,1090,1542,0.29312581
G1200950017015,12,95,17015,122,728,850,0.14352942
G1200950017016,12,95,17016,144,627,771,0.18677042
G1200950017017,12,95,17017,13,188,201,0.06467662
G1200950017103,12,95,17103,123,1378,1501,0.081945367
G1200950017104,12,95,17104,250,3579,3829,0.065291196
G1200950017105,12,95,17105,4,1715,1719,0.002326934
G1200950017107,12,95,17107,26,635,661,0.039334342
G1200950017108,12,95,17108,228,764,992,0.22983871
G1200950017109,12,95,17109,32,580,612,0.052287582
G1200950017200,12,95,17200,86,256,342,0.25146198
G1200950017300,12,95,17300,331,718,1049,0.31553861
G1200950017400,12,95,17400,187,1180,1367,0.13679591
G1200950017501,12,95,17501,160,893,1053,0.15194681
G1200950017503,12,95,17503,253,496,749,0.33778372
G1200950017504,12,95,17504,172,546,718,0.23955432
G1200950017600,12,95,17600,156,379,535,0.29158878
G1200950017701,12,95,17701,123,640,763,0.16120577
G1200950017702,12,95,17702,16,228,244,0.065573767
G1200950017703,12,95,17703,254,310,564,0.45035461
G1200950017802,12,95,17802,164,1224,1388,0.11815562
G1200950017804,12,95,17804,153,831,984,0.15548781
G1200950017805,12,95,17805,177,214,391,0.45268542
G1200950017806,12,95,17806,41,443,484,0.084710747
G1200950017807,12,95,17807,85,331,416,0.20432693
G1200950017808,12,95,17808,13,344,357,0.036414567
G1200950017901,12,95,17901,99,177,276,0.35869566
G1200950017902,12,95,17902,243,397,640,0.37968749
G1200950018000,12,95,18000,42,149,191,0.21989529
G1200950018100,12,95,18100,34,211,245,0.13877551
G1200950018200,12,95,18200,248,655,903,0.27464008
G1200950018300,12,95,18300,46,48,94,0.4893617
G1200950018400,12,95,18400,72,76,148,0.48648649
G1200950018500,12,95,18500,73,177,250,0.292
G1200950018700,12,95,18700,261,229,490,0.53265303
G1200950018800,12,95,18800,18,127,145,0.12413793
G1200950018900,12,95,18900,112,195,307,0.36482084
G1200950990000,12,95,990000,0,0,0,
G1200970040801,12,97,40801,37,61,98,0.37755102
G1200970040802,12,97,40802,93,703,796,0.11683417
G1200970040803,12,97,40803,126,701,827,0.15235792
G1200970040804,12,97,40804,70,348,418,0.16746412
G1200970040901,12,97,40901,130,451,581,0.22375216
G1200970040902,12,97,40902,458,282,740,0.6189189
G1200970041001,12,97,41001,137,888,1025,0.13365854
G1200970041002,12,97,41002,305,878,1183,0.25781912
G1200970041100,12,97,41100,650,1491,2141,0.30359644
G1200970041300,12,97,41300,604,1429,2033,0.29709789
G1200970041500,12,97,41500,362,955,1317,0.27486712
G1200970041600,12,97,41600,187,210,397,0.47103274
G1200970041700,12,97,41700,124,252,376,0.32978722
G1200970041800,12,97,41800,170,109,279,0.60931897
G1200970041900,12,97,41900,239,506,745,0.32080537
G1200970042000,12,97,42000,310,374,684,0.45321637
G1200970042100,12,97,42100,354,668,1022,0.34637964
G1200970042200,12,97,42200,210,480,690,0.30434781
G1200970042300,12,97,42300,229,305,534,0.42883894
G1200970042400,12,97,42400,210,623,833,0.25210086
G1200970042500,12,97,42500,60,662,722,0.083102494
G1200970042601,12,97,42601,58,399,457,0.12691467
G1200970042602,12,97,42602,506,763,1269,0.39873916
G1200970042701,12,97,42701,233,480,713,0.32678822
G1200970042702,12,97,42702,338,553,891,0.37934905
G1200970042800,12,97,42800,466,744,1210,0.38512397
G1200970042900,12,97,42900,664,1482,2146,0.30941287
G1200970043100,12,97,43100,0,285,285,0
G1200970043201,12,97,43201,0,3,3,0
G1200970043202,12,97,43202,0,24,24,0
G1200970043203,12,97,43203,79,328,407,0.1941032
G1200970043204,12,97,43204,207,1563,1770,0.11694916
G1200970043205,12,97,43205,8,148,156,0.051282052
G1200970043206,12,97,43206,3,9,12,0.25
G1200970043301,12,97,43301,8,168,176,0.045454547
G1200970043302,12,97,43302,118,1101,1219,0.096800655
G1200970043400,12,97,43400,138,344,482,0.28630707
G1200970043500,12,97,43500,78,277,355,0.21971831
G1200970043600,12,97,43600,100,473,573,0.17452008
G1200970043700,12,97,43700,72,356,428,0.1682243
G1200970043800,12,97,43800,165,536,701,0.23537803
G1200990000101,12,99,101,46,651,697,0.065997131
G1200990000102,12,99,102,12,150,162,0.074074075
G1200990000202,12,99,202,21,380,401,0.052369077
G1200990000204,12,99,204,92,245,337,0.27299702
G1200990000205,12,99,205,87,378,465,0.18709677
G1200990000206,12,99,206,40,696,736,0.054347824
G1200990000208,12,99,208,11,456,467,0.023554605
G1200990000209,12,99,209,36,717,753,0.047808766
G1200990000210,12,99,210,28,423,451,0.062084258
G1200990000211,12,99,211,9,396,405,0.022222223
G1200990000213,12,99,213,26,130,156,0.16666667
G1200990000214,12,99,214,76,914,990,0.076767676
G1200990000215,12,99,215,70,899,969,0.072239421
G1200990000301,12,99,301,58,196,254,0.22834645
G1200990000303,12,99,303,0,370,370,0
G1200990000304,12,99,304,32,349,381,0.083989501
G1200990000405,12,99,405,6,96,102,0.05882353
G1200990000406,12,99,406,9,60,69,0.13043478
G1200990000407,12,99,407,0,0,0,
G1200990000408,12,99,408,24,92,116,0.20689656
G1200990000410,12,99,410,8,189,197,0.040609136
G1200990000505,12,99,505,0,24,24,0
G1200990000507,12,99,507,0,28,28,0
G1200990000509,12,99,509,0,27,27,0
G1200990000511,12,99,511,0,54,54,0
G1200990000600,12,99,600,0,109,109,0
G1200990000702,12,99,702,16,240,256,0.0625
G1200990000703,12,99,703,0,339,339,0
G1200990000802,12,99,802,76,153,229,0.33187774
G1200990000803,12,99,803,15,137,152,0.098684214
G1200990000804,12,99,804,0,230,230,0
G1200990000902,12,99,902,30,194,224,0.13392857
G1200990000903,12,99,903,102,360,462,0.22077923
G1200990000904,12,99,904,31,190,221,0.1402715
G1200990000905,12,99,905,0,225,225,0
G1200990001002,12,99,1002,109,610,719,0.15159944
G1200990001003,12,99,1003,0,423,423,0
G1200990001004,12,99,1004,108,322,430,0.2511628
G1200990001101,12,99,1101,205,433,638,0.3213166
G1200990001102,12,99,1102,0,64,64,0
G1200990001200,12,99,1200,117,223,340,0.34411764
G1200990001301,12,99,1301,215,408,623,0.34510434
G1200990001302,12,99,1302,106,239,345,0.30724639
G1200990001402,12,99,1402,122,170,292,0.4178082
G1200990001403,12,99,1403,194,85,279,0.69534051
G1200990001404,12,99,1404,189,220,409,0.46210268
G1200990001500,12,99,1500,76,192,268,0.28358209
G1200990001600,12,99,1600,201,105,306,0.65686274
G1200990001700,12,99,1700,144,217,361,0.39889196
G1200990001801,12,99,1801,171,262,433,0.39491916
G1200990001802,12,99,1802,13,265,278,0.046762589
G1200990001904,12,99,1904,60,211,271,0.22140221
G1200990001907,12,99,1907,8,152,160,0.050000001
G1200990001908,12,99,1908,100,460,560,0.17857143
G1200990001909,12,99,1909,112,82,194,0.57731956
G1200990001910,12,99,1910,0,0,0,
G1200990001911,12,99,1911,0,0,0,
G1200990001912,12,99,1912,0,0,0,
G1200990001913,12,99,1913,0,0,0,
G1200990001914,12,99,1914,0,148,148,0
G1200990001915,12,99,1915,0,546,546,0
G1200990001916,12,99,1916,31,99,130,0.23846154
G1200990001917,12,99,1917,103,197,300,0.34333333
G1200990002005,12,99,2005,62,204,266,0.23308271
G1200990002006,12,99,2006,79,197,276,0.28623188
G1200990002100,12,99,2100,112,153,265,0.42264152
G1200990002200,12,99,2200,108,101,209,0.5167464
G1200990002300,12,99,2300,104,86,190,0.54736841
G1200990002400,12,99,2400,30,117,147,0.20408164
G1200990002600,12,99,2600,19,16,35,0.54285717
G1200990002700,12,99,2700,0,151,151,0
G1200990002800,12,99,2800,44,190,234,0.18803419
G1200990002900,12,99,2900,394,287,681,0.57856095
G1200990003000,12,99,3000,293,382,675,0.43407407
G1200990003101,12,99,3101,392,593,985,0.39796954
G1200990003102,12,99,3102,383,416,799,0.4793492
G1200990003201,12,99,3201,16,388,404,0.03960396
G1200990003202,12,99,3202,116,433,549,0.21129327
G1200990003300,12,99,3300,147,250,397,0.37027708
G1200990003400,12,99,3400,30,101,131,0.22900763
G1200990003504,12,99,3504,14,32,46,0.30434781
G1200990003507,12,99,3507,0,142,142,0
G1200990003509,12,99,3509,0,52,52,0
G1200990003511,12,99,3511,0,33,33,0
G1200990003600,12,99,3600,139,328,467,0.29764453
G1200990003700,12,99,3700,244,304,548,0.44525549
G1200990003800,12,99,3800,185,629,814,0.22727273
G1200990003901,12,99,3901,78,270,348,0.22413793
G1200990003902,12,99,3902,165,533,698,0.23638968
G1200990004005,12,99,4005,3,420,423,0.007092198
G1200990004007,12,99,4007,123,448,571,0.21541156
G1200990004008,12,99,4008,224,457,681,0.32892805
G1200990004009,12,99,4009,233,251,484,0.48140496
G1200990004010,12,99,4010,159,300,459,0.34640524
G1200990004011,12,99,4011,106,551,657,0.16133942
G1200990004012,12,99,4012,0,99,99,0
G1200990004013,12,99,4013,35,113,148,0.23648648
G1200990004101,12,99,4101,156,375,531,0.2937853
G1200990004102,12,99,4102,104,316,420,0.24761905
G1200990004201,12,99,4201,380,651,1031,0.3685742
G1200990004202,12,99,4202,122,213,335,0.3641791
G1200990004203,12,99,4203,38,121,159,0.2389937
G1200990004300,12,99,4300,18,416,434,0.041474655
G1200990004401,12,99,4401,80,278,358,0.22346368
G1200990004402,12,99,4402,266,230,496,0.53629035
G1200990004500,12,99,4500,352,328,680,0.51764709
G1200990004601,12,99,4601,167,235,402,0.41542289
G1200990004602,12,99,4602,143,410,553,0.25858951
G1200990004702,12,99,4702,158,533,691,0.22865413
G1200990004704,12,99,4704,436,421,857,0.50875145
G1200990004705,12,99,4705,264,303,567,0.46560848
G1200990004706,12,99,4706,84,154,238,0.35294119
G1200990004809,12,99,4809,27,38,65,0.41538462
G1200990004810,12,99,4810,12,271,283,0.042402826
G1200990004811,12,99,4811,1,283,284,0.003521127
G1200990004812,12,99,4812,147,737,884,0.1662896
G1200990004813,12,99,4813,41,671,712,0.057584271
G1200990004815,12,99,4815,51,528,579,0.088082902
G1200990004816,12,99,4816,80,128,208,0.38461539
G1200990004817,12,99,4817,39,76,115,0.33913043
G1200990004818,12,99,4818,5,128,133,0.037593983
G1200990004819,12,99,4819,162,264,426,0.38028169
G1200990004902,12,99,4902,0,127,127,0
G1200990004903,12,99,4903,331,319,650,0.50923079
G1200990004904,12,99,4904,220,399,619,0.35541195
G1200990005000,12,99,5000,65,385,450,0.14444445
G1200990005101,12,99,5101,147,87,234,0.62820512
G1200990005102,12,99,5102,297,431,728,0.40796703
G1200990005202,12,99,5202,60,175,235,0.25531915
G1200990005203,12,99,5203,52,76,128,0.40625
G1200990005204,12,99,5204,182,237,419,0.43436754
G1200990005300,12,99,5300,28,218,246,0.11382114
G1200990005405,12,99,5405,4,2,6,0.66666669
G1200990005407,12,99,5407,0,4,4,0
G1200990005409,12,99,5409,0,42,42,0
G1200990005411,12,99,5411,6,130,136,0.044117648
G1200990005501,12,99,5501,109,236,345,0.31594202
G1200990005502,12,99,5502,186,428,614,0.30293161
G1200990005601,12,99,5601,31,466,497,0.062374245
G1200990005602,12,99,5602,24,90,114,0.21052632
G1200990005701,12,99,5701,147,151,298,0.49328858
G1200990005702,12,99,5702,207,396,603,0.34328359
G1200990005807,12,99,5807,80,446,526,0.15209125
G1200990005808,12,99,5808,26,402,428,0.060747664
G1200990005810,12,99,5810,0,14,14,0
G1200990005811,12,99,5811,10,272,282,0.035460994
G1200990005812,12,99,5812,129,261,390,0.33076924
G1200990005813,12,99,5813,29,377,406,0.071428575
G1200990005814,12,99,5814,247,389,636,0.38836479
G1200990005815,12,99,5815,31,444,475,0.06526316
G1200990005816,12,99,5816,67,493,560,0.11964285
G1200990005817,12,99,5817,47,568,615,0.076422766
G1200990005903,12,99,5903,96,1032,1128,0.08510638
G1200990005915,12,99,5915,57,160,217,0.26267281
G1200990005916,12,99,5916,97,776,873,0.11111111
G1200990005917,12,99,5917,17,523,540,0.031481482
G1200990005918,12,99,5918,80,333,413,0.19370461
G1200990005921,12,99,5921,34,708,742,0.045822103
G1200990005922,12,99,5922,18,288,306,0.05882353
G1200990005923,12,99,5923,19,73,92,0.20652173
G1200990005926,12,99,5926,125,42,167,0.74850297
G1200990005930,12,99,5930,40,117,157,0.25477707
G1200990005931,12,99,5931,0,43,43,0
G1200990005933,12,99,5933,0,0,0,
G1200990005934,12,99,5934,18,28,46,0.39130434
G1200990005935,12,99,5935,0,37,37,0
G1200990005936,12,99,5936,0,53,53,0
G1200990005937,12,99,5937,59,79,138,0.42753622
G1200990005938,12,99,5938,11,155,166,0.066265061
G1200990005939,12,99,5939,0,0,0,
G1200990005940,12,99,5940,0,0,0,
G1200990005942,12,99,5942,36,168,204,0.17647059
G1200990005943,12,99,5943,0,12,12,0
G1200990005944,12,99,5944,0,0,0,
G1200990005945,12,99,5945,0,103,103,0
G1200990005946,12,99,5946,8,999,1007,0.007944389
G1200990005947,12,99,5947,0,0,0,
G1200990005949,12,99,5949,21,147,168,0.125
G1200990005950,12,99,5950,9,386,395,0.022784811
G1200990005951,12,99,5951,119,271,390,0.30512822
G1200990005952,12,99,5952,0,0,0,
G1200990005953,12,99,5953,10,79,89,0.11235955
G1200990005954,12,99,5954,0,111,111,0
G1200990005955,12,99,5955,0,75,75,0
G1200990005956,12,99,5956,0,0,0,
G1200990006005,12,99,6005,6,271,277,0.02166065
G1200990006006,12,99,6006,0,51,51,0
G1200990006007,12,99,6007,143,279,422,0.33886257
G1200990006008,12,99,6008,0,126,126,0
G1200990006009,12,99,6009,0,0,0,
G1200990006010,12,99,6010,22,217,239,0.09205021
G1200990006011,12,99,6011,33,99,132,0.25
G1200990006012,12,99,6012,19,236,255,0.074509807
G1200990006100,12,99,6100,209,219,428,0.48831776
G1200990006201,12,99,6201,189,339,528,0.35795453
G1200990006202,12,99,6202,35,43,78,0.44871795
G1200990006203,12,99,6203,18,80,98,0.18367347
G1200990006300,12,99,6300,48,388,436,0.11009175
G1200990006401,12,99,6401,0,86,86,0
G1200990006402,12,99,6402,98,167,265,0.36981133
G1200990006501,12,99,6501,46,137,183,0.25136611
G1200990006502,12,99,6502,61,121,182,0.33516484
G1200990006602,12,99,6602,0,336,336,0
G1200990006603,12,99,6603,0,184,184,0
G1200990006604,12,99,6604,112,272,384,0.29166666
G1200990006605,12,99,6605,40,182,222,0.18018018
G1200990006700,12,99,6700,64,144,208,0.30769232
G1200990006801,12,99,6801,234,341,575,0.40695652
G1200990006802,12,99,6802,131,182,313,0.41853034
G1200990006906,12,99,6906,0,213,213,0
G1200990006907,12,99,6907,0,192,192,0
G1200990006908,12,99,6908,33,168,201,0.1641791
G1200990006909,12,99,6909,8,149,157,0.050955415
G1200990006910,12,99,6910,8,30,38,0.21052632
G1200990006911,12,99,6911,43,91,134,0.32089552
G1200990006912,12,99,6912,16,221,237,0.067510545
G1200990007002,12,99,7002,14,279,293,0.047781572
G1200990007005,12,99,7005,18,154,172,0.10465116
G1200990007006,12,99,7006,22,129,151,0.14569536
G1200990007007,12,99,7007,67,405,472,0.14194915
G1200990007008,12,99,7008,0,581,581,0
G1200990007009,12,99,7009,36,401,437,0.082379863
G1200990007010,12,99,7010,15,16,31,0.48387095
G1200990007011,12,99,7011,0,168,168,0
G1200990007100,12,99,7100,0,0,0,
G1200990007201,12,99,7201,103,342,445,0.23146068
G1200990007202,12,99,7202,30,337,367,0.081743866
G1200990007203,12,99,7203,82,359,441,0.18594104
G1200990007301,12,99,7301,41,196,237,0.17299578
G1200990007302,12,99,7302,67,434,501,0.13373253
G1200990007407,12,99,7407,14,80,94,0.14893617
G1200990007410,12,99,7410,0,76,76,0
G1200990007412,12,99,7412,10,31,41,0.24390244
G1200990007414,12,99,7414,18,28,46,0.39130434
G1200990007416,12,99,7416,26,100,126,0.20634921
G1200990007418,12,99,7418,0,9,9,0
G1200990007420,12,99,7420,0,48,48,0
G1200990007501,12,99,7501,31,182,213,0.14553991
G1200990007504,12,99,7504,54,166,220,0.24545455
G1200990007505,12,99,7505,0,69,69,0
G1200990007602,12,99,7602,41,397,438,0.093607306
G1200990007603,12,99,7603,0,252,252,0
G1200990007604,12,99,7604,26,721,747,0.03480589
G1200990007605,12,99,7605,74,423,497,0.14889336
G1200990007607,12,99,7607,34,431,465,0.073118277
G1200990007610,12,99,7610,26,339,365,0.071232878
G1200990007612,12,99,7612,145,339,484,0.29958677
G1200990007613,12,99,7613,12,244,256,0.046875
G1200990007614,12,99,7614,0,272,272,0
G1200990007615,12,99,7615,74,302,376,0.19680852
G1200990007616,12,99,7616,0,105,105,0
G1200990007617,12,99,7617,0,33,33,0
G1200990007618,12,99,7618,10,458,468,0.021367522
G1200990007705,12,99,7705,24,440,464,0.05172414
G1200990007710,12,99,7710,56,421,477,0.11740042
G1200990007713,12,99,7713,12,1901,1913,0.00627287
G1200990007716,12,99,7716,50,508,558,0.089605734
G1200990007721,12,99,7721,16,450,466,0.034334764
G1200990007723,12,99,7723,48,257,305,0.15737705
G1200990007724,12,99,7724,62,788,850,0.072941177
G1200990007725,12,99,7725,60,662,722,0.083102494
G1200990007730,12,99,7730,17,690,707,0.024045262
G1200990007731,12,99,7731,55,423,478,0.11506276
G1200990007732,12,99,7732,213,537,750,0.28400001
G1200990007733,12,99,7733,8,315,323,0.024767801
G1200990007734,12,99,7734,6,250,256,0.0234375
G1200990007735,12,99,7735,16,731,747,0.021419009
G1200990007736,12,99,7736,7,437,444,0.015765766
G1200990007738,12,99,7738,81,394,475,0.17052631
G1200990007739,12,99,7739,58,129,187,0.31016043
G1200990007740,12,99,7740,117,379,496,0.2358871
G1200990007741,12,99,7741,0,328,328,0
G1200990007742,12,99,7742,0,392,392,0
G1200990007743,12,99,7743,88,554,642,0.13707165
G1200990007744,12,99,7744,0,44,44,0
G1200990007746,12,99,7746,0,0,0,
G1200990007747,12,99,7747,0,0,0,
G1200990007748,12,99,7748,114,542,656,0.17378049
G1200990007749,12,99,7749,96,424,520,0.18461539
G1200990007750,12,99,7750,161,554,715,0.22517483
G1200990007751,12,99,7751,29,309,338,0.085798815
G1200990007752,12,99,7752,40,669,709,0.056417488
G1200990007753,12,99,7753,92,793,885,0.1039548
G1200990007754,12,99,7754,53,130,183,0.28961748
G1200990007756,12,99,7756,0,239,239,0
G1200990007757,12,99,7757,0,290,290,0
G1200990007758,12,99,7758,387,434,821,0.47137636
G1200990007759,12,99,7759,8,96,104,0.07692308
G1200990007760,12,99,7760,0,449,449,0
G1200990007762,12,99,7762,26,180,206,0.1262136
G1200990007763,12,99,7763,92,917,1009,0.091179386
G1200990007764,12,99,7764,0,135,135,0
G1200990007765,12,99,7765,25,1312,1337,0.018698579
G1200990007766,12,99,7766,185,194,379,0.48812664
G1200990007767,12,99,7767,50,412,462,0.10822511
G1200990007805,12,99,7805,36,453,489,0.073619634
G1200990007808,12,99,7808,143,554,697,0.205165
G1200990007809,12,99,7809,72,264,336,0.21428572
G1200990007812,12,99,7812,146,421,567,0.25749558
G1200990007813,12,99,7813,70,659,729,0.09602195
G1200990007814,12,99,7814,6,84,90,0.06666667
G1200990007817,12,99,7817,116,888,1004,0.11553785
G1200990007818,12,99,7818,18,85,103,0.17475729
G1200990007820,12,99,7820,21,167,188,0.11170213
G1200990007821,12,99,7821,0,217,217,0
G1200990007822,12,99,7822,14,568,582,0.024054984
G1200990007823,12,99,7823,22,350,372,0.059139784
G1200990007828,12,99,7828,0,165,165,0
G1200990007830,12,99,7830,0,210,210,0
G1200990007831,12,99,7831,15,157,172,0.087209299
G1200990007832,12,99,7832,45,174,219,0.20547946
G1200990007833,12,99,7833,201,265,466,0.43133047
G1200990007834,12,99,7834,0,45,45,0
G1200990007835,12,99,7835,0,345,345,0
G1200990007836,12,99,7836,77,751,828,0.092995167
G1200990007837,12,99,7837,16,404,420,0.03809524
G1200990007838,12,99,7838,51,1072,1123,0.045414068
G1200990007839,12,99,7839,91,637,728,0.125
G1200990007908,12,99,7908,55,703,758,0.072559364
G1200990007909,12,99,7909,4,209,213,0.018779343
G1200990007910,12,99,7910,69,674,743,0.092866756
G1200990007912,12,99,7912,200,856,1056,0.18939394
G1200990008001,12,99,8001,68,258,326,0.20858896
G1200990008002,12,99,8002,340,191,531,0.64030135
G1200990008101,12,99,8101,104,582,686,0.15160351
G1200990008102,12,99,8102,0,0,0,
G1200990008201,12,99,8201,189,80,269,0.70260221
G1200990008202,12,99,8202,182,147,329,0.55319148
G1200990008203,12,99,8203,203,367,570,0.35614035
G1200990008301,12,99,8301,164,94,258,0.63565892
G1200990008302,12,99,8302,139,185,324,0.42901236
G1200990980000,12,99,980000,0,0,0,
G1200990980100,12,99,980100,0,0,0,
G1200990980200,12,99,980200,0,0,0,
G1200990980400,12,99,980400,0,0,0,
G1200990980500,12,99,980500,0,0,0,
G1200990990000,12,99,990000,0,0,0,
G1200990990100,12,99,990100,0,0,0,
G1201010030101,12,101,30101,100,124,224,0.44642857
G1201010030102,12,101,30102,134,116,250,0.53600001
G1201010030202,12,101,30202,19,98,117,0.16239317
G1201010030203,12,101,30203,60,35,95,0.63157892
G1201010030204,12,101,30204,32,46,78,0.41025642
G1201010030205,12,101,30205,20,128,148,0.13513513
G1201010030301,12,101,30301,59,71,130,0.45384616
G1201010030302,12,101,30302,36,51,87,0.41379312
G1201010030303,12,101,30303,118,141,259,0.45559844
G1201010030404,12,101,30404,113,192,305,0.3704918
G1201010030405,12,101,30405,93,113,206,0.45145631
G1201010030406,12,101,30406,22,79,101,0.21782178
G1201010030407,12,101,30407,118,169,287,0.41114983
G1201010030408,12,101,30408,11,90,101,0.10891089
G1201010030409,12,101,30409,8,194,202,0.03960396
G1201010030410,12,101,30410,10,122,132,0.075757578
G1201010030411,12,101,30411,22,175,197,0.11167513
G1201010030412,12,101,30412,132,151,283,0.46643108
G1201010030501,12,101,30501,16,64,80,0.2
G1201010030502,12,101,30502,75,220,295,0.25423729
G1201010030601,12,101,30601,0,117,117,0
G1201010030602,12,101,30602,83,187,270,0.30740741
G1201010030700,12,101,30700,147,343,490,0.30000001
G1201010030800,12,101,30800,28,74,102,0.27450982
G1201010030901,12,101,30901,25,300,325,0.07692308
G1201010030903,12,101,30903,49,103,152,0.32236841
G1201010030904,12,101,30904,95,190,285,0.33333334
G1201010030905,12,101,30905,0,212,212,0
G1201010031003,12,101,31003,256,224,480,0.53333336
G1201010031005,12,101,31005,55,191,246,0.22357723
G1201010031006,12,101,31006,60,96,156,0.38461539
G1201010031007,12,101,31007,99,228,327,0.30275229
G1201010031008,12,101,31008,30,63,93,0.32258064
G1201010031009,12,101,31009,34,140,174,0.19540229
G1201010031010,12,101,31010,169,286,455,0.37142858
G1201010031011,12,101,31011,32,147,179,0.17877094
G1201010031012,12,101,31012,69,188,257,0.26848248
G1201010031013,12,101,31013,103,213,316,0.32594937
G1201010031014,12,101,31014,16,209,225,0.071111113
G1201010031101,12,101,31101,74,192,266,0.2781955
G1201010031102,12,101,31102,32,132,164,0.19512194
G1201010031203,12,101,31203,0,56,56,0
G1201010031204,12,101,31204,0,228,228,0
G1201010031205,12,101,31205,17,175,192,0.088541664
G1201010031206,12,101,31206,76,205,281,0.27046263
G1201010031207,12,101,31207,33,139,172,0.19186047
G1201010031208,12,101,31208,17,338,355,0.047887325
G1201010031301,12,101,31301,0,172,172,0
G1201010031302,12,101,31302,21,622,643,0.032659408
G1201010031401,12,101,31401,111,181,292,0.380137
G1201010031404,12,101,31404,109,155,264,0.41287878
G1201010031405,12,101,31405,22,105,127,0.17322835
G1201010031406,12,101,31406,48,93,141,0.34042552
G1201010031407,12,101,31407,47,154,201,0.23383084
G1201010031408,12,101,31408,66,181,247,0.26720649
G1201010031409,12,101,31409,234,251,485,0.48247424
G1201010031503,12,101,31503,51,165,216,0.2361111
G1201010031504,12,101,31504,0,170,170,0
G1201010031505,12,101,31505,14,530,544,0.025735294
G1201010031506,12,101,31506,37,389,426,0.086854458
G1201010031507,12,101,31507,27,629,656,0.041158538
G1201010031508,12,101,31508,22,446,468,0.047008548
G1201010031601,12,101,31601,26,328,354,0.073446326
G1201010031602,12,101,31602,101,712,813,0.12423124
G1201010031603,12,101,31603,34,882,916,0.037117902
G1201010031604,12,101,31604,62,703,765,0.081045754
G1201010031605,12,101,31605,29,171,200,0.145
G1201010031701,12,101,31701,41,184,225,0.18222222
G1201010031703,12,101,31703,162,302,464,0.34913793
G1201010031704,12,101,31704,16,442,458,0.034934498
G1201010031705,12,101,31705,6,389,395,0.015189873
G1201010031706,12,101,31706,0,351,351,0
G1201010031707,12,101,31707,28,208,236,0.11864407
G1201010031708,12,101,31708,0,442,442,0
G1201010031804,12,101,31804,58,87,145,0.40000001
G1201010031805,12,101,31805,31,153,184,0.16847827
G1201010031806,12,101,31806,26,347,373,0.069705091
G1201010031807,12,101,31807,79,146,225,0.35111111
G1201010031808,12,101,31808,16,138,154,0.1038961
G1201010031809,12,101,31809,103,152,255,0.40392157
G1201010031901,12,101,31901,4,215,219,0.018264839
G1201010031902,12,101,31902,31,565,596,0.052013423
G1201010031903,12,101,31903,77,730,807,0.095415115
G1201010032001,12,101,32001,23,603,626,0.036741216
G1201010032005,12,101,32005,10,171,181,0.055248618
G1201010032006,12,101,32006,149,614,763,0.19528179
G1201010032007,12,101,32007,31,177,208,0.14903846
G1201010032008,12,101,32008,98,463,561,0.17468806
G1201010032009,12,101,32009,0,670,670,0
G1201010032010,12,101,32010,14,342,356,0.039325844
G1201010032011,12,101,32011,11,496,507,0.021696253
G1201010032012,12,101,32012,110,511,621,0.17713365
G1201010032013,12,101,32013,0,327,327,0
G1201010032014,12,101,32014,0,690,690,0
G1201010032103,12,101,32103,59,614,673,0.08766716
G1201010032104,12,101,32104,94,445,539,0.17439704
G1201010032105,12,101,32105,64,630,694,0.092219017
G1201010032106,12,101,32106,64,1197,1261,0.05075337
G1201010032107,12,101,32107,8,615,623,0.012841091
G1201010032108,12,101,32108,11,385,396,0.027777778
G1201010032109,12,101,32109,16,347,363,0.044077136
G1201010032110,12,101,32110,2,311,313,0.006389776
G1201010032111,12,101,32111,22,313,335,0.065671645
G1201010032112,12,101,32112,57,546,603,0.094527364
G1201010032113,12,101,32113,34,516,550,0.061818182
G1201010032200,12,101,32200,38,259,297,0.12794612
G1201010032300,12,101,32300,0,197,197,0
G1201010032401,12,101,32401,18,154,172,0.10465116
G1201010032402,12,101,32402,210,170,380,0.55263156
G1201010032500,12,101,32500,166,376,542,0.30627307
G1201010032601,12,101,32601,137,182,319,0.42946708
G1201010032602,12,101,32602,98,147,245,0.40000001
G1201010032700,12,101,32700,104,49,153,0.67973858
G1201010032801,12,101,32801,38,117,155,0.24516129
G1201010032802,12,101,32802,72,156,228,0.31578946
G1201010032803,12,101,32803,134,69,203,0.66009849
G1201010032804,12,101,32804,33,95,128,0.2578125
G1201010032901,12,101,32901,91,233,324,0.28086421
G1201010032902,12,101,32902,26,107,133,0.19548872
G1201010032903,12,101,32903,9,101,110,0.081818178
G1201010032904,12,101,32904,12,88,100,0.12
G1201010033005,12,101,33005,18,201,219,0.08219178
G1201010033006,12,101,33006,0,120,120,0
G1201010033007,12,101,33007,0,32,32,0
G1201010033008,12,101,33008,33,107,140,0.23571429
G1201010033009,12,101,33009,0,39,39,0
G1201010033010,12,101,33010,72,245,317,0.22712934
G1201010033011,12,101,33011,23,63,86,0.26744187
G1201010033012,12,101,33012,30,133,163,0.18404908
G1201010033013,12,101,33013,111,275,386,0.28756475
G1201010033014,12,101,33014,0,166,166,0
G1201010033101,12,101,33101,14,64,78,0.17948718
G1201010033102,12,101,33102,19,63,82,0.23170732
G1201010990000,12,101,990000,0,0,0,
G1201030020101,12,103,20101,176,239,415,0.42409638
G1201030020105,12,103,20105,9,235,244,0.036885247
G1201030020106,12,103,20106,15,177,192,0.078125
G1201030020107,12,103,20107,0,53,53,0
G1201030020108,12,103,20108,72,32,104,0.69230771
G1201030020201,12,103,20201,99,351,450,0.22
G1201030020202,12,103,20202,67,151,218,0.30733946
G1201030020206,12,103,20206,19,308,327,0.058103975
G1201030020207,12,103,20207,24,104,128,0.1875
G1201030020208,12,103,20208,64,148,212,0.3018868
G1201030020209,12,103,20209,120,257,377,0.31830239
G1201030020301,12,103,20301,83,216,299,0.27759197
G1201030020302,12,103,20302,73,194,267,0.27340823
G1201030020400,12,103,20400,26,179,205,0.12682927
G1201030020500,12,103,20500,138,139,277,0.49819493
G1201030020600,12,103,20600,140,183,323,0.43343654
G1201030020700,12,103,20700,98,265,363,0.26997244
G1201030020800,12,103,20800,316,218,534,0.59176028
G1201030021200,12,103,21200,160,118,278,0.57553959
G1201030021500,12,103,21500,10,20,30,0.33333334
G1201030021600,12,103,21600,68,16,84,0.80952382
G1201030021800,12,103,21800,60,118,178,0.33707866
G1201030021900,12,103,21900,51,132,183,0.27868852
G1201030022000,12,103,22000,105,220,325,0.32307693
G1201030022100,12,103,22100,128,369,497,0.25754526
G1201030022200,12,103,22200,111,199,310,0.3580645
G1201030022301,12,103,22301,24,186,210,0.11428571
G1201030022302,12,103,22302,0,206,206,0
G1201030022401,12,103,22401,24,219,243,0.098765433
G1201030022402,12,103,22402,244,302,546,0.44688645
G1201030022501,12,103,22501,136,327,463,0.29373649
G1201030022502,12,103,22502,0,299,299,0
G1201030022503,12,103,22503,44,501,545,0.080733947
G1201030022601,12,103,22601,55,177,232,0.23706897
G1201030022602,12,103,22602,55,196,251,0.21912351
G1201030022700,12,103,22700,154,200,354,0.43502825
G1201030022801,12,103,22801,111,213,324,0.3425926
G1201030022802,12,103,22802,42,197,239,0.17573221
G1201030022901,12,103,22901,66,117,183,0.36065573
G1201030022902,12,103,22902,59,127,186,0.3172043
G1201030023000,12,103,23000,50,124,174,0.28735632
G1201030023100,12,103,23100,77,83,160,0.48124999
G1201030023200,12,103,23200,66,148,214,0.30841121
G1201030023300,12,103,23300,21,137,158,0.1329114
G1201030023400,12,103,23400,23,76,99,0.23232323
G1201030023500,12,103,23500,54,110,164,0.32926831
G1201030023600,12,103,23600,0,75,75,0
G1201030023700,12,103,23700,0,214,214,0
G1201030023800,12,103,23800,35,141,176,0.19886364
G1201030023900,12,103,23900,24,89,113,0.21238938
G1201030024001,12,103,24001,11,289,300,0.036666665
G1201030024002,12,103,24002,0,341,341,0
G1201030024004,12,103,24004,15,481,496,0.030241935
G1201030024005,12,103,24005,62,293,355,0.17464788
G1201030024100,12,103,24100,87,215,302,0.28807947
G1201030024200,12,103,24200,101,259,360,0.28055555
G1201030024301,12,103,24301,40,280,320,0.125
G1201030024302,12,103,24302,46,390,436,0.10550459
G1201030024403,12,103,24403,36,216,252,0.14285715
G1201030024406,12,103,24406,61,147,208,0.29326922
G1201030024408,12,103,24408,86,357,443,0.19413093
G1201030024409,12,103,24409,0,162,162,0
G1201030024410,12,103,24410,80,211,291,0.27491409
G1201030024411,12,103,24411,15,323,338,0.044378698
G1201030024412,12,103,24412,0,184,184,0
G1201030024413,12,103,24413,67,169,236,0.28389829
G1201030024505,12,103,24505,150,580,730,0.20547946
G1201030024507,12,103,24507,50,185,235,0.21276596
G1201030024508,12,103,24508,183,436,619,0.29563811
G1201030024509,12,103,24509,0,212,212,0
G1201030024510,12,103,24510,53,195,248,0.21370968
G1201030024511,12,103,24511,18,599,617,0.029173419
G1201030024512,12,103,24512,0,124,124,0
G1201030024513,12,103,24513,0,6,6,0
G1201030024514,12,103,24514,72,191,263,0.27376425
G1201030024601,12,103,24601,7,190,197,0.035532996
G1201030024602,12,103,24602,267,130,397,0.67254406
G1201030024701,12,103,24701,20,117,137,0.14598539
G1201030024702,12,103,24702,31,118,149,0.20805369
G1201030024703,12,103,24703,85,199,284,0.29929578
G1201030024801,12,103,24801,105,265,370,0.28378379
G1201030024803,12,103,24803,23,118,141,0.16312057
G1201030024804,12,103,24804,20,134,154,0.12987013
G1201030024805,12,103,24805,72,145,217,0.33179724
G1201030024901,12,103,24901,91,380,471,0.19320594
G1201030024902,12,103,24902,355,235,590,0.60169494
G1201030024904,12,103,24904,65,297,362,0.17955801
G1201030024905,12,103,24905,155,515,670,0.23134328
G1201030024906,12,103,24906,65,222,287,0.22648084
G1201030025004,12,103,25004,168,352,520,0.32307693
G1201030025007,12,103,25007,21,258,279,0.07526882
G1201030025009,12,103,25009,27,236,263,0.10266159
G1201030025010,12,103,25010,97,258,355,0.27323943
G1201030025011,12,103,25011,30,423,453,0.066225164
G1201030025012,12,103,25012,69,408,477,0.1446541
G1201030025013,12,103,25013,35,199,234,0.14957266
G1201030025014,12,103,25014,35,448,483,0.072463766
G1201030025015,12,103,25015,7,39,46,0.15217391
G1201030025016,12,103,25016,31,118,149,0.20805369
G1201030025017,12,103,25017,30,98,128,0.234375
G1201030025018,12,103,25018,72,157,229,0.31441048
G1201030025019,12,103,25019,69,100,169,0.40828404
G1201030025106,12,103,25106,0,135,135,0
G1201030025107,12,103,25107,18,124,142,0.12676056
G1201030025108,12,103,25108,25,94,119,0.21008404
G1201030025109,12,103,25109,115,261,376,0.30585107
G1201030025110,12,103,25110,0,553,553,0
G1201030025111,12,103,25111,0,38,38,0
G1201030025112,12,103,25112,0,225,225,0
G1201030025113,12,103,25113,46,182,228,0.20175439
G1201030025114,12,103,25114,42,130,172,0.24418604
G1201030025115,12,103,25115,92,197,289,0.31833911
G1201030025116,12,103,25116,0,146,146,0
G1201030025119,12,103,25119,64,484,548,0.11678832
G1201030025120,12,103,25120,4,307,311,0.012861736
G1201030025121,12,103,25121,24,305,329,0.072948329
G1201030025122,12,103,25122,0,348,348,0
G1201030025123,12,103,25123,0,161,161,0
G1201030025203,12,103,25203,56,257,313,0.17891374
G1201030025204,12,103,25204,19,148,167,0.11377245
G1201030025205,12,103,25205,20,231,251,0.079681277
G1201030025207,12,103,25207,172,482,654,0.26299694
G1201030025208,12,103,25208,0,51,51,0
G1201030025209,12,103,25209,137,324,461,0.29718006
G1201030025303,12,103,25303,121,135,256,0.47265625
G1201030025304,12,103,25304,0,146,146,0
G1201030025305,12,103,25305,28,72,100,0.28
G1201030025306,12,103,25306,17,98,115,0.14782609
G1201030025307,12,103,25307,74,334,408,0.18137255
G1201030025308,12,103,25308,0,133,133,0
G1201030025401,12,103,25401,61,458,519,0.11753372
G1201030025405,12,103,25405,0,80,80,0
G1201030025407,12,103,25407,70,411,481,0.14553015
G1201030025408,12,103,25408,340,372,712,0.4775281
G1201030025411,12,103,25411,50,148,198,0.25252524
G1201030025412,12,103,25412,55,203,258,0.21317829
G1201030025413,12,103,25413,46,117,163,0.28220859
G1201030025414,12,103,25414,23,66,89,0.25842696
G1201030025415,12,103,25415,0,215,215,0
G1201030025416,12,103,25416,84,130,214,0.39252338
G1201030025417,12,103,25417,57,8,65,0.87692308
G1201030025501,12,103,25501,16,314,330,0.048484847
G1201030025503,12,103,25503,66,124,190,0.34736842
G1201030025505,12,103,25505,125,175,300,0.41666666
G1201030025506,12,103,25506,27,432,459,0.05882353
G1201030025602,12,103,25602,49,136,185,0.26486486
G1201030025603,12,103,25603,29,144,173,0.16763006
G1201030025604,12,103,25604,20,82,102,0.19607843
G1201030025700,12,103,25700,17,328,345,0.049275361
G1201030025800,12,103,25800,218,170,388,0.56185567
G1201030025900,12,103,25900,218,181,399,0.54636592
G1201030026001,12,103,26001,35,101,136,0.25735295
G1201030026002,12,103,26002,0,97,97,0
G1201030026101,12,103,26101,20,139,159,0.12578617
G1201030026102,12,103,26102,0,60,60,0
G1201030026200,12,103,26200,76,80,156,0.48717949
G1201030026300,12,103,26300,261,299,560,0.46607143
G1201030026400,12,103,26400,37,475,512,0.072265625
G1201030026500,12,103,26500,180,385,565,0.31858408
G1201030026601,12,103,26601,40,248,288,0.1388889
G1201030026602,12,103,26602,124,206,330,0.37575758
G1201030026701,12,103,26701,96,313,409,0.23471883
G1201030026702,12,103,26702,35,479,514,0.068093382
G1201030026703,12,103,26703,79,443,522,0.15134099
G1201030026804,12,103,26804,72,583,655,0.10992366
G1201030026809,12,103,26809,38,183,221,0.17194571
G1201030026811,12,103,26811,14,463,477,0.029350106
G1201030026812,12,103,26812,0,377,377,0
G1201030026813,12,103,26813,73,342,415,0.17590362
G1201030026814,12,103,26814,18,108,126,0.14285715
G1201030026815,12,103,26815,36,443,479,0.075156577
G1201030026816,12,103,26816,75,278,353,0.21246459
G1201030026817,12,103,26817,20,301,321,0.062305298
G1201030026818,12,103,26818,118,296,414,0.28502417
G1201030026819,12,103,26819,48,78,126,0.38095239
G1201030026820,12,103,26820,0,123,123,0
G1201030026821,12,103,26821,25,198,223,0.11210762
G1201030026904,12,103,26904,109,356,465,0.2344086
G1201030026907,12,103,26907,0,399,399,0
G1201030026908,12,103,26908,0,285,285,0
G1201030026909,12,103,26909,0,270,270,0
G1201030026910,12,103,26910,0,280,280,0
G1201030026911,12,103,26911,0,147,147,0
G1201030026912,12,103,26912,41,124,165,0.24848485
G1201030026913,12,103,26913,35,69,104,0.33653846
G1201030027000,12,103,27000,56,225,281,0.19928825
G1201030027101,12,103,27101,36,51,87,0.41379312
G1201030027105,12,103,27105,0,263,263,0
G1201030027106,12,103,27106,13,377,390,0.033333335
G1201030027202,12,103,27202,40,483,523,0.076481834
G1201030027204,12,103,27204,67,264,331,0.20241691
G1201030027205,12,103,27205,114,321,435,0.26206896
G1201030027206,12,103,27206,0,512,512,0
G1201030027207,12,103,27207,86,450,536,0.16044776
G1201030027208,12,103,27208,64,659,723,0.088520057
G1201030027209,12,103,27209,3,5,8,0.375
G1201030027210,12,103,27210,53,298,351,0.15099715
G1201030027308,12,103,27308,0,265,265,0
G1201030027309,12,103,27309,26,94,120,0.21666667
G1201030027310,12,103,27310,17,908,925,0.018378379
G1201030027314,12,103,27314,20,226,246,0.08130081
G1201030027315,12,103,27315,15,154,169,0.088757396
G1201030027316,12,103,27316,5,171,176,0.028409092
G1201030027317,12,103,27317,0,487,487,0
G1201030027318,12,103,27318,0,265,265,0
G1201030027319,12,103,27319,41,323,364,0.11263736
G1201030027320,12,103,27320,99,325,424,0.23349057
G1201030027321,12,103,27321,15,155,170,0.088235296
G1201030027322,12,103,27322,0,530,530,0
G1201030027323,12,103,27323,0,251,251,0
G1201030027324,12,103,27324,52,287,339,0.15339233
G1201030027325,12,103,27325,43,259,302,0.14238411
G1201030027326,12,103,27326,133,277,410,0.32439023
G1201030027327,12,103,27327,147,326,473,0.31078225
G1201030027401,12,103,27401,21,165,186,0.11290322
G1201030027402,12,103,27402,166,381,547,0.3034735
G1201030027403,12,103,27403,24,68,92,0.26086956
G1201030027501,12,103,27501,104,331,435,0.23908046
G1201030027502,12,103,27502,34,484,518,0.065637067
G1201030027603,12,103,27603,39,158,197,0.19796954
G1201030027604,12,103,27604,0,27,27,0
G1201030027605,12,103,27605,8,92,100,0.079999998
G1201030027606,12,103,27606,14,33,47,0.29787233
G1201030027701,12,103,27701,28,135,163,0.17177914
G1201030027703,12,103,27703,0,16,16,0
G1201030027704,12,103,27704,6,92,98,0.06122449
G1201030027801,12,103,27801,10,40,50,0.2
G1201030027802,12,103,27802,21,129,150,0.14
G1201030027901,12,103,27901,12,0,12,1
G1201030027903,12,103,27903,4,44,48,0.083333336
G1201030027904,12,103,27904,29,152,181,0.160221
G1201030028002,12,103,28002,0,301,301,0
G1201030028003,12,103,28003,51,118,169,0.30177516
G1201030028004,12,103,28004,5,81,86,0.058139537
G1201030028102,12,103,28102,22,140,162,0.13580246
G1201030028103,12,103,28103,0,54,54,0
G1201030028104,12,103,28104,0,23,23,0
G1201030028200,12,103,28200,44,157,201,0.21890548
G1201030028300,12,103,28300,46,133,179,0.25698325
G1201030028401,12,103,28401,0,0,0,
G1201030028402,12,103,28402,10,64,74,0.13513513
G1201030028500,12,103,28500,62,55,117,0.52991456
G1201030028600,12,103,28600,0,92,92,0
G1201030028700,12,103,28700,195,179,374,0.52139038
G1201030990000,12,103,990000,0,0,0,
G1201030990100,12,103,990100,0,0,0,
G1201050010300,12,105,10300,125,340,465,0.26881722
G1201050010401,12,105,10401,26,42,68,0.38235295
G1201050010402,12,105,10402,49,229,278,0.176259
G1201050010501,12,105,10501,0,241,241,0
G1201050010502,12,105,10502,75,329,404,0.18564357
G1201050010601,12,105,10601,64,301,365,0.17534247
G1201050010603,12,105,10603,9,252,261,0.034482758
G1201050010604,12,105,10604,17,323,340,0.050000001
G1201050010701,12,105,10701,46,295,341,0.13489737
G1201050010702,12,105,10702,7,271,278,0.025179856
G1201050010800,12,105,10800,213,219,432,0.49305555
G1201050010900,12,105,10900,249,218,467,0.53319055
G1201050011000,12,105,11000,141,95,236,0.59745765
G1201050011100,12,105,11100,161,172,333,0.48348349
G1201050011202,12,105,11202,61,123,184,0.33152175
G1201050011203,12,105,11203,219,208,427,0.51288056
G1201050011204,12,105,11204,90,34,124,0.72580647
G1201050011300,12,105,11300,91,86,177,0.51412427
G1201050011400,12,105,11400,103,256,359,0.28690809
G1201050011501,12,105,11501,157,325,482,0.32572615
G1201050011502,12,105,11502,22,297,319,0.068965517
G1201050011603,12,105,11603,29,82,111,0.26126125
G1201050011604,12,105,11604,82,344,426,0.19248827
G1201050011605,12,105,11605,58,162,220,0.26363635
G1201050011606,12,105,11606,9,134,143,0.062937066
G1201050011704,12,105,11704,180,215,395,0.4556962
G1201050011721,12,105,11721,155,191,346,0.44797689
G1201050011722,12,105,11722,8,117,125,0.064000003
G1201050011731,12,105,11731,166,233,399,0.41604009
G1201050011732,12,105,11732,195,228,423,0.4609929
G1201050011821,12,105,11821,7,209,216,0.032407407
G1201050011822,12,105,11822,72,312,384,0.1875
G1201050011832,12,105,11832,41,547,588,0.06972789
G1201050011833,12,105,11833,56,1051,1107,0.050587174
G1201050011834,12,105,11834,73,597,670,0.10895523
G1201050011835,12,105,11835,35,401,436,0.08027523
G1201050011836,12,105,11836,0,331,331,0
G1201050011901,12,105,11901,95,411,506,0.18774703
G1201050011902,12,105,11902,26,258,284,0.091549292
G1201050011908,12,105,11908,60,294,354,0.16949153
G1201050011909,12,105,11909,0,279,279,0
G1201050011910,12,105,11910,34,185,219,0.15525115
G1201050011911,12,105,11911,49,373,422,0.11611374
G1201050011912,12,105,11912,20,107,127,0.15748031
G1201050011913,12,105,11913,53,185,238,0.22268908
G1201050012001,12,105,12001,162,416,578,0.28027681
G1201050012002,12,105,12002,9,58,67,0.13432837
G1201050012003,12,105,12003,117,209,326,0.35889572
G1201050012004,12,105,12004,10,151,161,0.062111802
G1201050012111,12,105,12111,15,262,277,0.054151624
G1201050012113,12,105,12113,52,620,672,0.077380955
G1201050012124,12,105,12124,106,321,427,0.24824356
G1201050012125,12,105,12125,56,199,255,0.21960784
G1201050012126,12,105,12126,10,318,328,0.030487806
G1201050012127,12,105,12127,20,608,628,0.031847134
G1201050012128,12,105,12128,47,530,577,0.081455804
G1201050012129,12,105,12129,139,856,995,0.13969849
G1201050012203,12,105,12203,54,163,217,0.24884793
G1201050012204,12,105,12204,127,267,394,0.32233503
G1201050012205,12,105,12205,9,72,81,0.11111111
G1201050012206,12,105,12206,18,308,326,0.055214725
G1201050012303,12,105,12303,67,269,336,0.19940476
G1201050012304,12,105,12304,35,599,634,0.055205047
G1201050012305,12,105,12305,88,110,198,0.44444445
G1201050012306,12,105,12306,52,190,242,0.21487603
G1201050012307,12,105,12307,94,171,265,0.35471699
G1201050012309,12,105,12309,17,74,91,0.18681319
G1201050012403,12,105,12403,80,778,858,0.09324009
G1201050012404,12,105,12404,20,46,66,0.30303031
G1201050012405,12,105,12405,59,380,439,0.13439636
G1201050012406,12,105,12406,41,198,239,0.17154811
G1201050012407,12,105,12407,5,122,127,0.039370079
G1201050012408,12,105,12408,83,229,312,0.26602563
G1201050012409,12,105,12409,75,138,213,0.35211268
G1201050012410,12,105,12410,12,251,263,0.045627378
G1201050012411,12,105,12411,168,345,513,0.32748538
G1201050012502,12,105,12502,147,449,596,0.24664429
G1201050012503,12,105,12503,340,840,1180,0.28813559
G1201050012504,12,105,12504,328,219,547,0.59963435
G1201050012506,12,105,12506,82,513,595,0.13781513
G1201050012507,12,105,12507,91,426,517,0.17601547
G1201050012601,12,105,12601,87,400,487,0.17864476
G1201050012602,12,105,12602,485,389,874,0.5549199
G1201050012700,12,105,12700,206,481,687,0.29985443
G1201050012802,12,105,12802,78,217,295,0.26440677
G1201050012803,12,105,12803,0,67,67,0
G1201050012804,12,105,12804,40,128,168,0.23809524
G1201050012900,12,105,12900,367,191,558,0.65770608
G1201050013001,12,105,13001,0,426,426,0
G1201050013002,12,105,13002,217,139,356,0.60955054
G1201050013101,12,105,13101,48,368,416,0.11538462
G1201050013102,12,105,13102,137,189,326,0.42024541
G1201050013103,12,105,13103,57,39,96,0.59375
G1201050013200,12,105,13200,38,119,157,0.24203822
G1201050013300,12,105,13300,66,95,161,0.40993789
G1201050013400,12,105,13400,83,298,381,0.21784776
G1201050013500,12,105,13500,103,151,254,0.4055118
G1201050013600,12,105,13600,233,337,570,0.40877193
G1201050013701,12,105,13701,38,94,132,0.28787878
G1201050013702,12,105,13702,60,449,509,0.11787819
G1201050013801,12,105,13801,71,267,338,0.21005917
G1201050013802,12,105,13802,224,513,737,0.30393487
G1201050013901,12,105,13901,84,197,281,0.29893237
G1201050013902,12,105,13902,42,382,424,0.099056602
G1201050014001,12,105,14001,41,227,268,0.15298508
G1201050014003,12,105,14003,141,244,385,0.36623377
G1201050014005,12,105,14005,28,328,356,0.078651689
G1201050014006,12,105,14006,79,236,315,0.25079367
G1201050014103,12,105,14103,613,951,1564,0.39194372
G1201050014104,12,105,14104,0,10,10,0
G1201050014105,12,105,14105,190,587,777,0.24453025
G1201050014121,12,105,14121,82,123,205,0.40000001
G1201050014123,12,105,14123,29,485,514,0.056420233
G1201050014124,12,105,14124,24,94,118,0.20338982
G1201050014125,12,105,14125,58,492,550,0.10545454
G1201050014201,12,105,14201,91,319,410,0.22195122
G1201050014202,12,105,14202,18,155,173,0.10404624
G1201050014203,12,105,14203,42,132,174,0.24137931
G1201050014301,12,105,14301,124,27,151,0.82119203
G1201050014302,12,105,14302,274,400,674,0.4065282
G1201050014400,12,105,14400,127,418,545,0.23302752
G1201050014501,12,105,14501,312,417,729,0.42798355
G1201050014502,12,105,14502,237,217,454,0.52202642
G1201050014600,12,105,14600,136,326,462,0.29437229
G1201050014701,12,105,14701,38,244,282,0.13475177
G1201050014702,12,105,14702,74,649,723,0.10235132
G1201050014802,12,105,14802,64,118,182,0.35164836
G1201050014803,12,105,14803,0,209,209,0
G1201050014804,12,105,14804,75,583,658,0.11398176
G1201050014901,12,105,14901,71,975,1046,0.067877628
G1201050014902,12,105,14902,260,463,723,0.35961273
G1201050015000,12,105,15000,89,355,444,0.20045045
G1201050015101,12,105,15101,52,247,299,0.17391305
G1201050015102,12,105,15102,52,169,221,0.23529412
G1201050015200,12,105,15200,180,267,447,0.40268457
G1201050015301,12,105,15301,50,267,317,0.1577287
G1201050015302,12,105,15302,90,82,172,0.52325583
G1201050015401,12,105,15401,104,226,330,0.31515151
G1201050015402,12,105,15402,98,139,237,0.4135021
G1201050015404,12,105,15404,15,33,48,0.3125
G1201050015405,12,105,15405,52,177,229,0.22707424
G1201050015500,12,105,15500,149,286,435,0.34252873
G1201050015600,12,105,15600,24,127,151,0.1589404
G1201050015701,12,105,15701,55,180,235,0.23404256
G1201050015702,12,105,15702,82,107,189,0.43386245
G1201050015801,12,105,15801,70,56,126,0.55555558
G1201050015802,12,105,15802,72,191,263,0.27376425
G1201050015900,12,105,15900,25,143,168,0.14880952
G1201050016001,12,105,16001,45,184,229,0.19650654
G1201050016002,12,105,16002,21,182,203,0.10344828
G1201050016003,12,105,16003,82,145,227,0.36123347
G1201050016100,12,105,16100,6,36,42,0.14285715
G1201050016400,12,105,16400,25,41,66,0.37878788
G1201050980000,12,105,980000,24,0,24,1
G1201070950100,12,107,950100,51,255,306,0.16666667
G1201070950201,12,107,950201,74,235,309,0.23948219
G1201070950202,12,107,950202,184,184,368,0.5
G1201070950300,12,107,950300,168,265,433,0.38799077
G1201070950400,12,107,950400,17,260,277,0.061371841
G1201070950500,12,107,950500,173,375,548,0.31569344
G1201070950600,12,107,950600,177,206,383,0.46214098
G1201070950700,12,107,950700,281,59,340,0.82647061
G1201070950800,12,107,950800,126,128,254,0.49606299
G1201070950900,12,107,950900,101,236,337,0.29970327
G1201070951000,12,107,951000,17,250,267,0.063670412
G1201070951100,12,107,951100,55,190,245,0.22448979
G1201070951200,12,107,951200,283,239,522,0.54214561
G1201070951300,12,107,951300,86,205,291,0.29553264
G1201070951401,12,107,951401,193,77,270,0.71481484
G1201070951402,12,107,951402,144,156,300,0.47999999
G1201070980000,12,107,980000,0,0,0,
G1201090020200,12,109,20200,16,56,72,0.22222222
G1201090020300,12,109,20300,132,136,268,0.49253732
G1201090020400,12,109,20400,48,81,129,0.37209302
G1201090020500,12,109,20500,0,200,200,0
G1201090020601,12,109,20601,51,455,506,0.10079052
G1201090020602,12,109,20602,95,1811,1906,0.049842604
G1201090020704,12,109,20704,25,353,378,0.066137567
G1201090020705,12,109,20705,69,424,493,0.13995942
G1201090020706,12,109,20706,0,452,452,0
G1201090020707,12,109,20707,35,356,391,0.089514069
G1201090020708,12,109,20708,0,318,318,0
G1201090020710,12,109,20710,14,266,280,0.050000001
G1201090020711,12,109,20711,0,426,426,0
G1201090020801,12,109,20801,122,1238,1360,0.089705884
G1201090020802,12,109,20802,0,484,484,0
G1201090020803,12,109,20803,16,324,340,0.047058824
G1201090020804,12,109,20804,125,321,446,0.28026906
G1201090020805,12,109,20805,28,1894,1922,0.014568158
G1201090020806,12,109,20806,246,1104,1350,0.18222222
G1201090020807,12,109,20807,14,221,235,0.05957447
G1201090020901,12,109,20901,62,664,726,0.085399449
G1201090020902,12,109,20902,179,3115,3294,0.054341227
G1201090021002,12,109,21002,83,302,385,0.21558441
G1201090021003,12,109,21003,191,334,525,0.36380953
G1201090021004,12,109,21004,0,164,164,0
G1201090021101,12,109,21101,122,336,458,0.26637554
G1201090021102,12,109,21102,107,416,523,0.2045889
G1201090021103,12,109,21103,69,89,158,0.43670887
G1201090021203,12,109,21203,6,463,469,0.012793177
G1201090021204,12,109,21204,10,59,69,0.14492753
G1201090021205,12,109,21205,0,47,47,0
G1201090021206,12,109,21206,69,548,617,0.11183144
G1201090021301,12,109,21301,102,329,431,0.23665893
G1201090021302,12,109,21302,41,458,499,0.082164332
G1201090021403,12,109,21403,28,114,142,0.1971831
G1201090021404,12,109,21404,0,173,173,0
G1201090021405,12,109,21405,14,381,395,0.035443038
G1201090021406,12,109,21406,29,346,375,0.077333331
G1201090021407,12,109,21407,0,60,60,0
G1201090990100,12,109,990100,0,0,0,
G1201090990200,12,109,990200,0,0,0,
G1201110380100,12,111,380100,64,9,73,0.87671232
G1201110380200,12,111,380200,205,71,276,0.74275362
G1201110380300,12,111,380300,467,210,677,0.68980795
G1201110380400,12,111,380400,156,328,484,0.32231405
G1201110380500,12,111,380500,149,385,534,0.27902621
G1201110380600,12,111,380600,124,262,386,0.32124352
G1201110380700,12,111,380700,272,473,745,0.36510068
G1201110380800,12,111,380800,77,138,215,0.35813954
G1201110380901,12,111,380901,111,29,140,0.79285717
G1201110380902,12,111,380902,247,345,592,0.41722974
G1201110381000,12,111,381000,0,79,79,0
G1201110381101,12,111,381101,79,400,479,0.16492693
G1201110381102,12,111,381102,9,186,195,0.046153847
G1201110381204,12,111,381204,0,8,8,0
G1201110381300,12,111,381300,120,161,281,0.42704627
G1201110381401,12,111,381401,167,325,492,0.3394309
G1201110381402,12,111,381402,170,226,396,0.42929292
G1201110381502,12,111,381502,178,730,908,0.19603524
G1201110381503,12,111,381503,295,814,1109,0.2660054
G1201110381601,12,111,381601,29,301,330,0.087878786
G1201110381602,12,111,381602,0,67,67,0
G1201110381603,12,111,381603,13,145,158,0.082278483
G1201110381701,12,111,381701,12,11,23,0.52173913
G1201110381702,12,111,381702,0,0,0,
G1201110381802,12,111,381802,103,244,347,0.29682997
G1201110381803,12,111,381803,91,235,326,0.2791411
G1201110381804,12,111,381804,69,366,435,0.15862069
G1201110381900,12,111,381900,39,334,373,0.10455764
G1201110382002,12,111,382002,196,737,933,0.21007502
G1201110382003,12,111,382003,281,782,1063,0.26434618
G1201110382006,12,111,382006,28,553,581,0.048192769
G1201110382007,12,111,382007,211,313,524,0.40267175
G1201110382008,12,111,382008,0,664,664,0
G1201110382009,12,111,382009,117,176,293,0.39931741
G1201110382010,12,111,382010,0,93,93,0
G1201110382106,12,111,382106,438,2059,2497,0.17541049
G1201110382108,12,111,382108,532,1408,1940,0.27422681
G1201110382109,12,111,382109,0,728,728,0
G1201110382110,12,111,382110,28,722,750,0.037333332
G1201110382111,12,111,382111,360,1091,1451,0.24810475
G1201110382112,12,111,382112,177,440,617,0.28687197
G1201110382113,12,111,382113,414,987,1401,0.2955032
G1201110382200,12,111,382200,38,233,271,0.1402214
G1201110980000,12,111,980000,0,0,0,
G1201110990000,12,111,990000,0,0,0,
G1201130010100,12,113,10100,0,230,230,0
G1201130010200,12,113,10200,14,325,339,0.041297935
G1201130010300,12,113,10300,69,1287,1356,0.050884955
G1201130010400,12,113,10400,76,175,251,0.30278885
G1201130010502,12,113,10502,272,406,678,0.40117994
G1201130010503,12,113,10503,156,453,609,0.25615764
G1201130010504,12,113,10504,96,326,422,0.22748815
G1201130010600,12,113,10600,194,375,569,0.34094903
G1201130010702,12,113,10702,26,506,532,0.04887218
G1201130010704,12,113,10704,20,620,640,0.03125
G1201130010705,12,113,10705,90,250,340,0.2647059
G1201130010706,12,113,10706,169,727,896,0.18861607
G1201130010707,12,113,10707,16,468,484,0.03305785
G1201130010708,12,113,10708,48,573,621,0.077294685
G1201130010802,12,113,10802,68,341,409,0.16625917
G1201130010808,12,113,10808,75,298,373,0.20107238
G1201130010809,12,113,10809,234,298,532,0.43984962
G1201130010811,12,113,10811,231,1552,1783,0.12955692
G1201130010812,12,113,10812,18,493,511,0.035225049
G1201130010813,12,113,10813,37,438,475,0.07789474
G1201130010814,12,113,10814,17,575,592,0.028716216
G1201130010815,12,113,10815,223,803,1026,0.21734893
G1201130010817,12,113,10817,36,567,603,0.059701491
G1201130010819,12,113,10819,127,1036,1163,0.10920034
G1201130010900,12,113,10900,50,646,696,0.071839079
G1201130990000,12,113,990000,0,0,0,
G1201150000101,12,115,101,16,21,37,0.43243244
G1201150000102,12,115,102,147,99,246,0.597561
G1201150000200,12,115,200,87,344,431,0.20185615
G1201150000300,12,115,300,173,156,329,0.52583587
G1201150000401,12,115,401,21,240,261,0.080459774
G1201150000404,12,115,404,0,39,39,0
G1201150000405,12,115,405,77,183,260,0.29615384
G1201150000406,12,115,406,88,302,390,0.22564103
G1201150000407,12,115,407,48,219,267,0.17977528
G1201150000501,12,115,501,18,116,134,0.13432837
G1201150000502,12,115,502,12,158,170,0.070588239
G1201150000503,12,115,503,21,163,184,0.11413044
G1201150000601,12,115,601,32,203,235,0.13617021
G1201150000602,12,115,602,56,235,291,0.19243987
G1201150000700,12,115,700,0,86,86,0
G1201150000801,12,115,801,19,34,53,0.35849056
G1201150000802,12,115,802,4,4,8,0.5
G1201150000900,12,115,900,8,159,167,0.047904193
G1201150001000,12,115,1000,79,67,146,0.54109591
G1201150001101,12,115,1101,74,216,290,0.2551724
G1201150001102,12,115,1102,144,350,494,0.29149798
G1201150001201,12,115,1201,33,586,619,0.053311795
G1201150001202,12,115,1202,61,404,465,0.13118279
G1201150001203,12,115,1203,0,183,183,0
G1201150001204,12,115,1204,45,366,411,0.10948905
G1201150001301,12,115,1301,9,241,250,0.035999998
G1201150001302,12,115,1302,31,236,267,0.11610487
G1201150001303,12,115,1303,0,321,321,0
G1201150001304,12,115,1304,0,143,143,0
G1201150001401,12,115,1401,29,781,810,0.035802469
G1201150001402,12,115,1402,15,423,438,0.034246575
G1201150001403,12,115,1403,105,353,458,0.22925764
G1201150001503,12,115,1503,43,285,328,0.13109756
G1201150001504,12,115,1504,44,173,217,0.20276497
G1201150001505,12,115,1505,86,417,503,0.17097415
G1201150001506,12,115,1506,27,502,529,0.051039696
G1201150001507,12,115,1507,46,400,446,0.10313901
G1201150001601,12,115,1601,7,220,227,0.030837005
G1201150001602,12,115,1602,22,346,368,0.059782609
G1201150001702,12,115,1702,0,440,440,0
G1201150001703,12,115,1703,41,220,261,0.15708812
G1201150001704,12,115,1704,14,188,202,0.069306932
G1201150001801,12,115,1801,44,153,197,0.22335026
G1201150001803,12,115,1803,115,188,303,0.37953794
G1201150001804,12,115,1804,27,149,176,0.15340909
G1201150001805,12,115,1805,0,156,156,0
G1201150001903,12,115,1903,0,83,83,0
G1201150001904,12,115,1904,0,162,162,0
G1201150001905,12,115,1905,0,14,14,0
G1201150001907,12,115,1907,8,35,43,0.18604651
G1201150001908,12,115,1908,0,42,42,0
G1201150002003,12,115,2003,28,232,260,0.10769231
G1201150002004,12,115,2004,0,181,181,0
G1201150002005,12,115,2005,16,263,279,0.05734767
G1201150002007,12,115,2007,8,74,82,0.097560972
G1201150002008,12,115,2008,14,187,201,0.069651738
G1201150002009,12,115,2009,123,473,596,0.20637584
G1201150002010,12,115,2010,0,377,377,0
G1201150002100,12,115,2100,66,474,540,0.12222222
G1201150002201,12,115,2201,13,182,195,0.06666667
G1201150002202,12,115,2202,0,237,237,0
G1201150002203,12,115,2203,69,237,306,0.2254902
G1201150002302,12,115,2302,0,49,49,0
G1201150002303,12,115,2303,0,93,93,0
G1201150002304,12,115,2304,0,50,50,0
G1201150002305,12,115,2305,0,21,21,0
G1201150002401,12,115,2401,45,95,140,0.32142857
G1201150002402,12,115,2402,0,129,129,0
G1201150002504,12,115,2504,68,131,199,0.34170854
G1201150002505,12,115,2505,14,172,186,0.07526882
G1201150002507,12,115,2507,56,380,436,0.12844037
G1201150002508,12,115,2508,12,214,226,0.053097345
G1201150002509,12,115,2509,101,252,353,0.28611898
G1201150002510,12,115,2510,26,76,102,0.25490198
G1201150002511,12,115,2511,6,105,111,0.054054055
G1201150002601,12,115,2601,0,140,140,0
G1201150002602,12,115,2602,0,79,79,0
G1201150002603,12,115,2603,0,68,68,0
G1201150002604,12,115,2604,5,68,73,0.06849315
G1201150002605,12,115,2605,8,92,100,0.079999998
G1201150002710,12,115,2710,70,95,165,0.42424244
G1201150002711,12,115,2711,115,497,612,0.1879085
G1201150002712,12,115,2712,754,3831,4585,0.16444929
G1201150002713,12,115,2713,30,645,675,0.044444446
G1201150002714,12,115,2714,63,231,294,0.21428572
G1201150002715,12,115,2715,0,136,136,0
G1201150002716,12,115,2716,14,446,460,0.030434782
G1201150002718,12,115,2718,62,270,332,0.18674698
G1201150002719,12,115,2719,0,85,85,0
G1201150002720,12,115,2720,0,90,90,0
G1201150002721,12,115,2721,91,204,295,0.30847457
G1201150002722,12,115,2722,69,604,673,0.102526
G1201150002723,12,115,2723,36,80,116,0.31034482
G1201150002724,12,115,2724,0,0,0,
G1201150990000,12,115,990000,0,0,0,
G1201170020101,12,117,20101,67,26,93,0.72043014
G1201170020102,12,117,20102,39,17,56,0.6964286
G1201170020201,12,117,20201,20,165,185,0.10810811
G1201170020202,12,117,20202,73,353,426,0.17136151
G1201170020301,12,117,20301,82,83,165,0.4969697
G1201170020302,12,117,20302,80,108,188,0.42553192
G1201170020401,12,117,20401,82,81,163,0.50306749
G1201170020402,12,117,20402,0,231,231,0
G1201170020500,12,117,20500,117,40,157,0.74522293
G1201170020600,12,117,20600,371,954,1325,0.28
G1201170020701,12,117,20701,176,1168,1344,0.13095239
G1201170020703,12,117,20703,34,968,1002,0.033932135
G1201170020704,12,117,20704,13,416,429,0.030303031
G1201170020705,12,117,20705,24,227,251,0.095617533
G1201170020803,12,117,20803,20,462,482,0.041493777
G1201170020805,12,117,20805,30,523,553,0.054249547
G1201170020806,12,117,20806,62,433,495,0.12525253
G1201170020807,12,117,20807,200,443,643,0.31104198
G1201170020808,12,117,20808,64,381,445,0.14382023
G1201170020810,12,117,20810,34,314,348,0.097701147
G1201170020811,12,117,20811,101,355,456,0.22149123
G1201170020812,12,117,20812,60,272,332,0.18072289
G1201170020901,12,117,20901,110,175,285,0.3859649
G1201170020902,12,117,20902,30,68,98,0.30612245
G1201170020903,12,117,20903,383,769,1152,0.33246529
G1201170021000,12,117,21000,28,388,416,0.067307696
G1201170021100,12,117,21100,22,221,243,0.090534978
G1201170021201,12,117,21201,44,493,537,0.081936687
G1201170021203,12,117,21203,0,784,784,0
G1201170021204,12,117,21204,0,923,923,0
G1201170021306,12,117,21306,82,543,625,0.1312
G1201170021307,12,117,21307,64,724,788,0.081218272
G1201170021311,12,117,21311,24,382,406,0.059113301
G1201170021312,12,117,21312,36,314,350,0.10285714
G1201170021313,12,117,21313,157,468,625,0.25119999
G1201170021314,12,117,21314,33,354,387,0.085271321
G1201170021315,12,117,21315,0,613,613,0
G1201170021316,12,117,21316,12,259,271,0.044280443
G1201170021317,12,117,21317,187,722,909,0.20572057
G1201170021318,12,117,21318,53,797,850,0.06235294
G1201170021319,12,117,21319,0,121,121,0
G1201170021320,12,117,21320,47,710,757,0.062087186
G1201170021321,12,117,21321,36,260,296,0.12162162
G1201170021401,12,117,21401,129,480,609,0.21182266
G1201170021403,12,117,21403,0,735,735,0
G1201170021404,12,117,21404,100,474,574,0.17421603
G1201170021502,12,117,21502,96,238,334,0.28742516
G1201170021503,12,117,21503,53,101,154,0.34415585
G1201170021504,12,117,21504,8,178,186,0.043010753
G1201170021505,12,117,21505,0,249,249,0
G1201170021506,12,117,21506,20,227,247,0.080971658
G1201170021604,12,117,21604,31,346,377,0.082228117
G1201170021606,12,117,21606,79,520,599,0.13188648
G1201170021608,12,117,21608,247,286,533,0.46341464
G1201170021609,12,117,21609,0,292,292,0
G1201170021611,12,117,21611,16,536,552,0.028985508
G1201170021612,12,117,21612,28,360,388,0.072164945
G1201170021613,12,117,21613,44,192,236,0.18644068
G1201170021614,12,117,21614,72,367,439,0.16400911
G1201170021615,12,117,21615,22,234,256,0.0859375
G1201170021616,12,117,21616,29,256,285,0.10175438
G1201170021704,12,117,21704,117,288,405,0.2888889
G1201170021705,12,117,21705,88,190,278,0.31654677
G1201170021706,12,117,21706,131,219,350,0.37428573
G1201170021707,12,117,21707,175,320,495,0.35353535
G1201170021708,12,117,21708,39,665,704,0.055397727
G1201170021802,12,117,21802,100,356,456,0.21929824
G1201170021803,12,117,21803,46,147,193,0.23834197
G1201170021805,12,117,21805,0,184,184,0
G1201170021806,12,117,21806,0,191,191,0
G1201170021901,12,117,21901,41,310,351,0.11680911
G1201170021902,12,117,21902,66,214,280,0.23571429
G1201170022001,12,117,22001,38,119,157,0.24203822
G1201170022002,12,117,22002,48,256,304,0.15789473
G1201170022004,12,117,22004,0,104,104,0
G1201170022005,12,117,22005,66,474,540,0.12222222
G1201170022101,12,117,22101,77,376,453,0.16997792
G1201170022104,12,117,22104,146,465,611,0.23895253
G1201170022105,12,117,22105,20,228,248,0.080645159
G1201170022106,12,117,22106,38,685,723,0.052558783
G1201170022201,12,117,22201,22,386,408,0.053921569
G1201170022205,12,117,22205,14,240,254,0.05511811
G1201170022206,12,117,22206,19,245,264,0.071969695
G1201170022207,12,117,22207,88,386,474,0.18565401
G1201170022208,12,117,22208,32,221,253,0.12648222
G1201170022209,12,117,22209,173,207,380,0.45526317
G1201190910100,12,119,910100,218,221,439,0.49658313
G1201190910300,12,119,910300,4,105,109,0.036697246
G1201190910401,12,119,910401,67,110,177,0.37853107
G1201190910402,12,119,910402,40,113,153,0.26143792
G1201190910500,12,119,910500,39,385,424,0.091981135
G1201190910601,12,119,910601,30,217,247,0.12145749
G1201190910602,12,119,910602,83,157,240,0.34583333
G1201190910700,12,119,910700,311,247,558,0.55734766
G1201190910800,12,119,910800,0,0,0,
G1201190910900,12,119,910900,0,0,0,
G1201190911000,12,119,911000,0,0,0,
G1201190911200,12,119,911200,0,282,282,0
G1201190911301,12,119,911301,12,61,73,0.16438356
G1201190911302,12,119,911302,66,22,88,0.75
G1201190911400,12,119,911400,54,48,102,0.52941179
G1201190911500,12,119,911500,22,94,116,0.18965517
G1201190911701,12,119,911701,0,159,159,0
G1201190911702,12,119,911702,0,38,38,0
G1201190980000,12,119,980000,0,0,0,
G1201210970100,12,121,970100,294,387,681,0.43171805
G1201210970200,12,121,970200,162,230,392,0.41326532
G1201210970301,12,121,970301,60,61,121,0.49586776
G1201210970302,12,121,970302,157,255,412,0.38106796
G1201210970400,12,121,970400,333,506,839,0.39690107
G1201210970500,12,121,970500,170,556,726,0.23415978
G1201210970600,12,121,970600,219,407,626,0.34984025
G1201230950100,12,123,950100,56,254,310,0.18064517
G1201230950200,12,123,950200,24,328,352,0.06818182
G1201230950300,12,123,950300,94,420,514,0.18287937
G1201230950400,12,123,950400,0,340,340,0
G1201230990000,12,123,990000,0,0,0,
G1201250960100,12,125,960100,24,190,214,0.11214953
G1201250960200,12,125,960200,131,480,611,0.21440262
G1201250960300,12,125,960300,124,297,421,0.29453683
G1201270080100,12,127,80100,22,416,438,0.050228309
G1201270080201,12,127,80201,12,45,57,0.21052632
G1201270080202,12,127,80202,11,153,164,0.067073174
G1201270080300,12,127,80300,168,92,260,0.64615387
G1201270080400,12,127,80400,52,223,275,0.18909091
G1201270080500,12,127,80500,43,172,215,0.2
G1201270080600,12,127,80600,102,126,228,0.44736841
G1201270080700,12,127,80700,8,261,269,0.029739777
G1201270080803,12,127,80803,82,279,361,0.22714682
G1201270080804,12,127,80804,67,240,307,0.21824104
G1201270080805,12,127,80805,132,412,544,0.24264705
G1201270080806,12,127,80806,32,179,211,0.15165877
G1201270080807,12,127,80807,24,266,290,0.08275862
G1201270080901,12,127,80901,160,196,356,0.44943821
G1201270080902,12,127,80902,89,207,296,0.30067569
G1201270081000,12,127,81000,193,139,332,0.58132529
G1201270081101,12,127,81101,0,45,45,0
G1201270081102,12,127,81102,0,26,26,0
G1201270081200,12,127,81200,75,103,178,0.4213483
G1201270081300,12,127,81300,0,36,36,0
G1201270081500,12,127,81500,52,32,84,0.61904764
G1201270081600,12,127,81600,40,115,155,0.25806451
G1201270081700,12,127,81700,318,280,598,0.53177255
G1201270081800,12,127,81800,61,101,162,0.37654322
G1201270081900,12,127,81900,164,17,181,0.90607733
G1201270082000,12,127,82000,16,24,40,0.40000001
G1201270082100,12,127,82100,395,153,548,0.7208029
G1201270082201,12,127,82201,0,18,18,0
G1201270082202,12,127,82202,33,55,88,0.375
G1201270082301,12,127,82301,105,231,336,0.3125
G1201270082401,12,127,82401,124,195,319,0.38871473
G1201270082404,12,127,82404,36,134,170,0.21176471
G1201270082405,12,127,82405,31,153,184,0.16847827
G1201270082406,12,127,82406,25,258,283,0.088339224
G1201270082410,12,127,82410,47,394,441,0.10657597
G1201270082411,12,127,82411,0,101,101,0
G1201270082412,12,127,82412,0,160,160,0
G1201270082413,12,127,82413,96,205,301,0.31893688
G1201270082414,12,127,82414,0,92,92,0
G1201270082415,12,127,82415,22,131,153,0.14379086
G1201270082503,12,127,82503,301,223,524,0.57442749
G1201270082506,12,127,82506,70,191,261,0.26819924
G1201270082507,12,127,82507,74,528,602,0.12292359
G1201270082508,12,127,82508,72,332,404,0.17821783
G1201270082509,12,127,82509,0,354,354,0
G1201270082510,12,127,82510,20,151,171,0.11695907
G1201270082511,12,127,82511,53,104,157,0.33757961
G1201270082604,12,127,82604,3,105,108,0.027777778
G1201270082605,12,127,82605,8,33,41,0.19512194
G1201270082606,12,127,82606,0,138,138,0
G1201270082607,12,127,82607,16,76,92,0.17391305
G1201270082701,12,127,82701,0,121,121,0
G1201270082703,12,127,82703,23,71,94,0.24468085
G1201270082704,12,127,82704,0,68,68,0
G1201270082705,12,127,82705,80,83,163,0.49079755
G1201270082801,12,127,82801,61,123,184,0.33152175
G1201270082802,12,127,82802,42,145,187,0.22459893
G1201270082902,12,127,82902,38,330,368,0.10326087
G1201270082903,12,127,82903,159,211,370,0.42972973
G1201270082904,12,127,82904,82,222,304,0.26973686
G1201270083003,12,127,83003,64,232,296,0.21621622
G1201270083005,12,127,83005,26,146,172,0.15116279
G1201270083006,12,127,83006,75,468,543,0.13812155
G1201270083007,12,127,83007,82,354,436,0.1880734
G1201270083008,12,127,83008,9,102,111,0.081081077
G1201270083009,12,127,83009,86,291,377,0.22811671
G1201270083203,12,127,83203,20,738,758,0.026385223
G1201270083205,12,127,83205,0,153,153,0
G1201270083206,12,127,83206,8,95,103,0.077669904
G1201270083207,12,127,83207,70,370,440,0.15909091
G1201270083208,12,127,83208,178,853,1031,0.17264791
G1201270083209,12,127,83209,96,372,468,0.20512821
G1201270090101,12,127,90101,50,268,318,0.1572327
G1201270090102,12,127,90102,75,225,300,0.25
G1201270090202,12,127,90202,83,546,629,0.13195549
G1201270090203,12,127,90203,161,147,308,0.52272725
G1201270090204,12,127,90204,20,568,588,0.034013607
G1201270090303,12,127,90303,83,97,180,0.4611111
G1201270090304,12,127,90304,119,329,448,0.265625
G1201270090305,12,127,90305,10,394,404,0.024752475
G1201270090306,12,127,90306,43,261,304,0.14144737
G1201270090307,12,127,90307,52,489,541,0.096118301
G1201270090400,12,127,90400,130,213,343,0.37900874
G1201270090500,12,127,90500,0,37,37,0
G1201270090600,12,127,90600,268,247,515,0.52038836
G1201270090701,12,127,90701,52,366,418,0.12440191
G1201270090702,12,127,90702,161,424,585,0.27521369
G1201270090803,12,127,90803,110,341,451,0.24390244
G1201270090804,12,127,90804,105,459,564,0.18617021
G1201270090805,12,127,90805,24,309,333,0.072072074
G1201270090806,12,127,90806,98,272,370,0.26486486
G1201270090902,12,127,90902,100,704,804,0.12437811
G1201270090903,12,127,90903,18,225,243,0.074074075
G1201270090904,12,127,90904,19,403,422,0.045023698
G1201270091001,12,127,91001,84,500,584,0.14383562
G1201270091005,12,127,91005,36,134,170,0.21176471
G1201270091013,12,127,91013,85,561,646,0.13157895
G1201270091015,12,127,91015,216,225,441,0.48979592
G1201270091016,12,127,91016,181,365,546,0.33150184
G1201270091017,12,127,91017,71,383,454,0.15638767
G1201270091018,12,127,91018,256,537,793,0.32282472
G1201270091019,12,127,91019,165,329,494,0.3340081
G1201270091020,12,127,91020,146,358,504,0.28968254
G1201270091021,12,127,91021,25,230,255,0.098039217
G1201270091022,12,127,91022,237,497,734,0.32288828
G1201270091023,12,127,91023,38,149,187,0.20320855
G1201270091024,12,127,91024,89,719,808,0.11014851
G1201270091025,12,127,91025,102,413,515,0.19805825
G1201270091026,12,127,91026,110,352,462,0.23809524
G1201270091027,12,127,91027,29,576,605,0.047933884
G1201270091028,12,127,91028,25,242,267,0.093632959
G1201270091029,12,127,91029,32,313,345,0.092753626
G1201270092500,12,127,92500,72,193,265,0.27169812
G1201270990000,12,127,990000,0,0,0,
G1201290010100,12,129,10100,127,363,490,0.25918368
G1201290010201,12,129,10201,166,1082,1248,0.13301282
G1201290010202,12,129,10202,204,434,638,0.31974921
G1201290010203,12,129,10203,59,634,693,0.085137084
G1201290990000,12,129,990000,0,0,0,
G1201310950101,12,131,950101,166,238,404,0.41089109
G1201310950102,12,131,950102,120,133,253,0.47430831
G1201310950200,12,131,950200,72,196,268,0.26865673
G1201310950301,12,131,950301,141,562,703,0.20056899
G1201310950302,12,131,950302,80,355,435,0.18390805
G1201310950400,12,131,950400,84,161,245,0.34285715
G1201310950501,12,131,950501,203,214,417,0.48681056
G1201310950502,12,131,950502,28,279,307,0.091205209
G1201310950601,12,131,950601,0,766,766,0
G1201310950602,12,131,950602,0,239,239,0
G1201310950603,12,131,950603,51,396,447,0.11409396
G1201310990000,12,131,990000,0,0,0,
G1201330970102,12,133,970102,36,151,187,0.19251336
G1201330970103,12,133,970103,59,273,332,0.17771085
G1201330970104,12,133,970104,64,105,169,0.37869823
G1201330970200,12,133,970200,52,226,278,0.18705036
G1201330970301,12,133,970301,59,190,249,0.23694779
G1201330970302,12,133,970302,140,214,354,0.39548022
G1201330970303,12,133,970303,203,302,505,0.40198019
G3600010000100,36,1,100,125,117,242,0.5165289
G3600010000200,36,1,200,153,148,301,0.50830567
G3600010000300,36,1,300,92,189,281,0.32740214
G3600010000401,36,1,401,0,92,92,0
G3600010000403,36,1,403,20,180,200,0.1
G3600010000404,36,1,404,0,0,0,
G3600010000501,36,1,501,64,234,298,0.2147651
G3600010000502,36,1,502,13,42,55,0.23636363
G3600010000600,36,1,600,113,165,278,0.40647483
G3600010000700,36,1,700,152,207,359,0.42339832
G3600010000800,36,1,800,145,43,188,0.77127659
G3600010001100,36,1,1100,6,37,43,0.13953489
G3600010001400,36,1,1400,40,40,80,0.5
G3600010001500,36,1,1500,30,85,115,0.26086956
G3600010001600,36,1,1600,45,105,150,0.30000001
G3600010001700,36,1,1700,62,280,342,0.18128654
G3600010001801,36,1,1801,0,414,414,0
G3600010001802,36,1,1802,11,179,190,0.057894737
G3600010001901,36,1,1901,17,136,153,0.11111111
G3600010001902,36,1,1902,0,190,190,0
G3600010002000,36,1,2000,173,398,571,0.30297723
G3600010002100,36,1,2100,121,86,207,0.58454108
G3600010002200,36,1,2200,33,54,87,0.37931034
G3600010002300,36,1,2300,35,43,78,0.44871795
G3600010002500,36,1,2500,126,79,205,0.61463416
G3600010002600,36,1,2600,284,426,710,0.40000001
G3600010012700,36,1,12700,6,79,85,0.070588239
G3600010012800,36,1,12800,199,174,373,0.53351206
G3600010012900,36,1,12900,73,223,296,0.24662162
G3600010013000,36,1,13000,26,324,350,0.074285716
G3600010013100,36,1,13100,14,219,233,0.060085837
G3600010013200,36,1,13200,115,242,357,0.32212886
G3600010013300,36,1,13300,46,368,414,0.11111111
G3600010013400,36,1,13400,60,132,192,0.3125
G3600010013503,36,1,13503,58,493,551,0.10526316
G3600010013505,36,1,13505,29,181,210,0.13809524
G3600010013506,36,1,13506,104,438,542,0.19188192
G3600010013507,36,1,13507,78,152,230,0.33913043
G3600010013508,36,1,13508,72,585,657,0.10958904
G3600010013601,36,1,13601,82,610,692,0.11849711
G3600010013602,36,1,13602,26,281,307,0.084690556
G3600010013703,36,1,13703,26,116,142,0.18309858
G3600010013705,36,1,13705,24,376,400,0.059999999
G3600010013706,36,1,13706,13,208,221,0.05882353
G3600010013707,36,1,13707,23,487,510,0.04509804
G3600010013801,36,1,13801,14,659,673,0.020802377
G3600010013802,36,1,13802,18,488,506,0.035573121
G3600010013901,36,1,13901,44,172,216,0.2037037
G3600010013902,36,1,13902,67,316,383,0.17493473
G3600010014001,36,1,14001,10,255,265,0.03773585
G3600010014002,36,1,14002,41,262,303,0.13531353
G3600010014100,36,1,14100,0,494,494,0
G3600010014201,36,1,14201,63,664,727,0.086657494
G3600010014202,36,1,14202,0,545,545,0
G3600010014203,36,1,14203,0,517,517,0
G3600010014301,36,1,14301,32,204,236,0.13559322
G3600010014302,36,1,14302,0,896,896,0
G3600010014401,36,1,14401,30,304,334,0.089820363
G3600010014402,36,1,14402,19,304,323,0.05882353
G3600010014501,36,1,14501,0,197,197,0
G3600010014502,36,1,14502,36,330,366,0.098360658
G3600010014503,36,1,14503,12,250,262,0.045801528
G3600010014606,36,1,14606,21,374,395,0.053164557
G3600010014607,36,1,14607,13,939,952,0.013655462
G3600010014608,36,1,14608,0,193,193,0
G3600010014609,36,1,14609,43,331,374,0.11497326
G3600010014611,36,1,14611,16,205,221,0.072398193
G3600010014612,36,1,14612,8,139,147,0.054421768
G3600010014613,36,1,14613,3,250,253,0.011857707
G3600010014614,36,1,14614,66,550,616,0.10714286
G3600010014615,36,1,14615,18,141,159,0.11320755
G3600010014700,36,1,14700,15,258,273,0.054945055
G3600010014801,36,1,14801,40,232,272,0.14705883
G3600010014802,36,1,14802,38,111,149,0.25503355
G3600010014803,36,1,14803,0,294,294,0
G3600030940200,36,3,940200,0,0,0,
G3600030950100,36,3,950100,56,223,279,0.20071685
G3600030950300,36,3,950300,85,241,326,0.2607362
G3600030950400,36,3,950400,69,299,368,0.1875
G3600030950500,36,3,950500,28,256,284,0.098591551
G3600030950600,36,3,950600,165,228,393,0.41984734
G3600030950700,36,3,950700,56,225,281,0.19928825
G3600030950800,36,3,950800,36,204,240,0.15000001
G3600030950900,36,3,950900,75,271,346,0.216763
G3600030951000,36,3,951000,97,256,353,0.27478755
G3600030951100,36,3,951100,75,323,398,0.18844222
G3600030951200,36,3,951200,89,433,522,0.17049809
G3600030951300,36,3,951300,49,370,419,0.11694511
G3600050000100,36,5,100,0,0,0,
G3600050000200,36,5,200,51,443,494,0.10323887
G3600050000400,36,5,400,138,458,596,0.23154363
G3600050001600,36,5,1600,185,498,683,0.27086383
G3600050001900,36,5,1900,64,201,265,0.24150944
G3600050002000,36,5,2000,794,387,1181,0.6723116
G3600050002300,36,5,2300,503,183,686,0.73323613
G3600050002400,36,5,2400,0,30,30,0
G3600050002500,36,5,2500,461,353,814,0.56633908
G3600050002701,36,5,2701,280,162,442,0.63348418
G3600050002702,36,5,2702,436,281,717,0.60808927
G3600050002800,36,5,2800,30,567,597,0.050251257
G3600050003100,36,5,3100,18,125,143,0.12587413
G3600050003300,36,5,3300,411,195,606,0.67821783
G3600050003500,36,5,3500,206,269,475,0.4336842
G3600050003700,36,5,3700,0,23,23,0
G3600050003800,36,5,3800,62,65,127,0.48818898
G3600050003900,36,5,3900,189,454,643,0.29393467
G3600050004001,36,5,4001,25,105,130,0.1923077
G3600050004100,36,5,4100,671,366,1037,0.64705884
G3600050004200,36,5,4200,385,256,641,0.60062402
G3600050004300,36,5,4300,439,365,804,0.54601991
G3600050004400,36,5,4400,231,370,601,0.38435939
G3600050004600,36,5,4600,88,142,230,0.38260868
G3600050004800,36,5,4800,134,301,435,0.30804598
G3600050005001,36,5,5001,246,332,578,0.42560554
G3600050005002,36,5,5002,430,251,681,0.63142437
G3600050005100,36,5,5100,495,264,759,0.65217394
G3600050005200,36,5,5200,208,129,337,0.61721069
G3600050005300,36,5,5300,368,184,552,0.66666669
G3600050005400,36,5,5400,345,287,632,0.5458861
G3600050005600,36,5,5600,128,117,245,0.52244896
G3600050005902,36,5,5902,60,184,244,0.24590164
G3600050006000,36,5,6000,55,82,137,0.40145984
G3600050006100,36,5,6100,56,176,232,0.24137931
G3600050006200,36,5,6200,398,466,864,0.46064815
G3600050006300,36,5,6300,163,251,414,0.39371979
G3600050006400,36,5,6400,139,177,316,0.43987343
G3600050006500,36,5,6500,314,300,614,0.51140064
G3600050006700,36,5,6700,356,325,681,0.52276063
G3600050006800,36,5,6800,125,294,419,0.29832935
G3600050006900,36,5,6900,520,563,1083,0.48014775
G3600050007000,36,5,7000,215,278,493,0.43610549
G3600050007100,36,5,7100,129,161,290,0.44482759
G3600050007200,36,5,7200,364,310,674,0.54005933
G3600050007300,36,5,7300,220,270,490,0.44897959
G3600050007400,36,5,7400,123,244,367,0.33514985
G3600050007500,36,5,7500,319,459,778,0.41002572
G3600050007600,36,5,7600,296,369,665,0.44511279
G3600050007700,36,5,7700,128,154,282,0.45390069
G3600050007800,36,5,7800,230,497,727,0.31636864
G3600050007900,36,5,7900,443,245,688,0.64389533
G3600050008300,36,5,8300,400,397,797,0.50188208
G3600050008400,36,5,8400,46,234,280,0.16428572
G3600050008500,36,5,8500,300,414,714,0.42016807
G3600050008600,36,5,8600,304,320,624,0.48717949
G3600050008700,36,5,8700,253,578,831,0.30445248
G3600050008900,36,5,8900,120,212,332,0.36144578
G3600050009000,36,5,9000,211,276,487,0.43326488
G3600050009200,36,5,9200,217,430,647,0.33539411
G3600050009300,36,5,9300,352,370,722,0.48753461
G3600050009600,36,5,9600,26,293,319,0.081504703
G3600050009800,36,5,9800,172,343,515,0.33398059
G3600050011000,36,5,11000,0,14,14,0
G3600050011502,36,5,11502,334,318,652,0.51226991
G3600050011700,36,5,11700,95,149,244,0.38934427
G3600050011800,36,5,11800,43,313,356,0.12078652
G3600050011900,36,5,11900,258,424,682,0.37829912
G3600050012101,36,5,12101,190,176,366,0.5191257
G3600050012102,36,5,12102,149,96,245,0.60816324
G3600050012300,36,5,12300,294,312,606,0.48514852
G3600050012500,36,5,12500,287,252,539,0.53246754
G3600050012701,36,5,12701,168,104,272,0.61764705
G3600050012901,36,5,12901,254,318,572,0.44405594
G3600050013000,36,5,13000,7,101,108,0.064814813
G3600050013100,36,5,13100,225,399,624,0.36057693
G3600050013200,36,5,13200,78,589,667,0.11694153
G3600050013300,36,5,13300,179,477,656,0.27286586
G3600050013500,36,5,13500,307,258,565,0.54336286
G3600050013800,36,5,13800,0,152,152,0
G3600050014100,36,5,14100,214,472,686,0.31195337
G3600050014300,36,5,14300,68,50,118,0.57627118
G3600050014400,36,5,14400,287,428,715,0.4013986
G3600050014500,36,5,14500,720,382,1102,0.65335751
G3600050014701,36,5,14701,667,327,994,0.67102617
G3600050014702,36,5,14702,416,152,568,0.73239434
G3600050014900,36,5,14900,240,204,444,0.54054052
G3600050015100,36,5,15100,304,457,761,0.39947438
G3600050015200,36,5,15200,43,247,290,0.14827587
G3600050015300,36,5,15300,460,216,676,0.68047339
G3600050015500,36,5,15500,266,155,421,0.63182896
G3600050015700,36,5,15700,200,196,396,0.50505048
G3600050015800,36,5,15800,26,141,167,0.15568863
G3600050015900,36,5,15900,103,62,165,0.62424242
G3600050016000,36,5,16000,0,407,407,0
G3600050016100,36,5,16100,367,292,659,0.55690438
G3600050016200,36,5,16200,33,158,191,0.17277487
G3600050016300,36,5,16300,0,0,0,
G3600050016400,36,5,16400,20,40,60,0.33333334
G3600050016500,36,5,16500,67,48,115,0.5826087
G3600050016600,36,5,16600,41,240,281,0.14590748
G3600050016700,36,5,16700,156,228,384,0.40625
G3600050016900,36,5,16900,27,104,131,0.20610687
G3600050017100,36,5,17100,0,0,0,
G3600050017300,36,5,17300,258,571,829,0.31121832
G3600050017500,36,5,17500,506,406,912,0.55482459
G3600050017701,36,5,17701,477,246,723,0.65975106
G3600050017702,36,5,17702,315,366,681,0.46255508
G3600050017901,36,5,17901,420,126,546,0.76923078
G3600050017902,36,5,17902,145,269,414,0.35024154
G3600050018101,36,5,18101,231,156,387,0.59689921
G3600050018102,36,5,18102,230,252,482,0.47717842
G3600050018301,36,5,18301,89,297,386,0.23056994
G3600050018302,36,5,18302,231,218,449,0.5144766
G3600050018400,36,5,18400,70,252,322,0.2173913
G3600050018500,36,5,18500,396,545,941,0.42082891
G3600050018900,36,5,18900,589,641,1230,0.47886178
G3600050019300,36,5,19300,394,337,731,0.5389877
G3600050019400,36,5,19400,33,163,196,0.16836734
G3600050019500,36,5,19500,361,614,975,0.37025642
G3600050019700,36,5,19700,437,491,928,0.47090518
G3600050019900,36,5,19900,606,651,1257,0.48210025
G3600050020000,36,5,20000,334,330,664,0.50301206
G3600050020100,36,5,20100,289,248,537,0.53817505
G3600050020200,36,5,20200,94,146,240,0.39166668
G3600050020400,36,5,20400,129,283,412,0.31310681
G3600050020501,36,5,20501,482,652,1134,0.42504409
G3600050020502,36,5,20502,97,162,259,0.37451738
G3600050020601,36,5,20601,33,201,234,0.14102565
G3600050020900,36,5,20900,221,324,545,0.40550458
G3600050021001,36,5,21001,237,715,952,0.24894957
G3600050021002,36,5,21002,53,491,544,0.097426474
G3600050021100,36,5,21100,515,355,870,0.59195405
G3600050021200,36,5,21200,36,492,528,0.06818182
G3600050021301,36,5,21301,106,66,172,0.61627907
G3600050021302,36,5,21302,270,384,654,0.41284403
G3600050021501,36,5,21501,246,392,638,0.38557994
G3600050021502,36,5,21502,471,400,871,0.54075778
G3600050021601,36,5,21601,240,212,452,0.53097343
G3600050021602,36,5,21602,36,499,535,0.067289717
G3600050021700,36,5,21700,407,156,563,0.72291297
G3600050021800,36,5,21800,269,491,760,0.35394737
G3600050021900,36,5,21900,57,60,117,0.48717949
G3600050022000,36,5,22000,178,45,223,0.79820627
G3600050022101,36,5,22101,349,216,565,0.61769909
G3600050022102,36,5,22102,463,249,712,0.65028089
G3600050022200,36,5,22200,109,263,372,0.29301074
G3600050022300,36,5,22300,352,357,709,0.49647391
G3600050022401,36,5,22401,34,182,216,0.1574074
G3600050022403,36,5,22403,107,263,370,0.28918919
G3600050022404,36,5,22404,104,353,457,0.22757111
G3600050022500,36,5,22500,363,557,920,0.39456522
G3600050022701,36,5,22701,256,246,502,0.50996017
G3600050022702,36,5,22702,58,120,178,0.32584271
G3600050022703,36,5,22703,96,157,253,0.37944663
G3600050022800,36,5,22800,283,478,761,0.3718791
G3600050022901,36,5,22901,356,393,749,0.4753004
G3600050022902,36,5,22902,277,246,523,0.52963674
G3600050023000,36,5,23000,109,254,363,0.30027547
G3600050023100,36,5,23100,63,103,166,0.37951806
G3600050023200,36,5,23200,135,243,378,0.35714287
G3600050023301,36,5,23301,322,265,587,0.54855198
G3600050023302,36,5,23302,253,139,392,0.64540815
G3600050023501,36,5,23501,285,108,393,0.72519082
G3600050023502,36,5,23502,365,180,545,0.66972476
G3600050023600,36,5,23600,108,158,266,0.40601504
G3600050023702,36,5,23702,60,39,99,0.60606062
G3600050023703,36,5,23703,335,345,680,0.49264705
G3600050023704,36,5,23704,354,159,513,0.69005847
G3600050023800,36,5,23800,113,238,351,0.32193732
G3600050023900,36,5,23900,706,367,1073,0.65796834
G3600050024000,36,5,24000,186,341,527,0.35294119
G3600050024100,36,5,24100,391,446,837,0.46714458
G3600050024300,36,5,24300,384,319,703,0.54623044
G3600050024400,36,5,24400,38,280,318,0.11949685
G3600050024501,36,5,24501,314,240,554,0.566787
G3600050024502,36,5,24502,309,121,430,0.71860462
G3600050024600,36,5,24600,7,123,130,0.053846154
G3600050024700,36,5,24700,126,143,269,0.46840149
G3600050024800,36,5,24800,48,170,218,0.22018349
G3600050024900,36,5,24900,0,0,0,
G3600050025000,36,5,25000,10,256,266,0.037593983
G3600050025100,36,5,25100,205,360,565,0.36283186
G3600050025200,36,5,25200,64,173,237,0.27004218
G3600050025300,36,5,25300,214,405,619,0.34571889
G3600050025400,36,5,25400,42,147,189,0.22222222
G3600050025500,36,5,25500,542,231,773,0.70116431
G3600050025600,36,5,25600,29,106,135,0.21481481
G3600050025700,36,5,25700,28,67,95,0.29473683
G3600050026100,36,5,26100,38,106,144,0.2638889
G3600050026300,36,5,26300,273,338,611,0.44680852
G3600050026400,36,5,26400,71,445,516,0.13759691
G3600050026500,36,5,26500,266,410,676,0.39349112
G3600050026601,36,5,26601,75,151,226,0.3318584
G3600050026602,36,5,26602,109,404,513,0.21247563
G3600050026701,36,5,26701,172,210,382,0.45026177
G3600050026702,36,5,26702,343,528,871,0.39380023
G3600050026900,36,5,26900,200,316,516,0.38759691
G3600050027300,36,5,27300,329,626,955,0.34450263
G3600050027401,36,5,27401,0,330,330,0
G3600050027402,36,5,27402,60,189,249,0.24096386
G3600050027600,36,5,27600,4,8,12,0.33333334
G3600050027700,36,5,27700,275,369,644,0.42701864
G3600050027900,36,5,27900,171,393,564,0.30319148
G3600050028100,36,5,28100,0,180,180,0
G3600050028300,36,5,28300,206,253,459,0.44880176
G3600050028400,36,5,28400,0,14,14,0
G3600050028500,36,5,28500,75,181,256,0.29296875
G3600050028600,36,5,28600,13,72,85,0.15294118
G3600050028700,36,5,28700,100,285,385,0.25974026
G3600050028800,36,5,28800,29,288,317,0.091482647
G3600050028900,36,5,28900,51,371,422,0.12085308
G3600050029301,36,5,29301,45,122,167,0.26946107
G3600050029302,36,5,29302,0,324,324,0
G3600050029500,36,5,29500,43,290,333,0.12912913
G3600050029600,36,5,29600,29,106,135,0.21481481
G3600050029700,36,5,29700,0,318,318,0
G3600050030000,36,5,30000,10,421,431,0.023201857
G3600050030100,36,5,30100,0,44,44,0
G3600050030200,36,5,30200,61,725,786,0.077608146
G3600050030701,36,5,30701,28,394,422,0.066350713
G3600050030900,36,5,30900,11,270,281,0.039145909
G3600050031000,36,5,31000,22,233,255,0.086274512
G3600050031200,36,5,31200,0,168,168,0
G3600050031400,36,5,31400,18,158,176,0.10227273
G3600050031600,36,5,31600,92,152,244,0.37704918
G3600050031800,36,5,31800,44,118,162,0.27160493
G3600050031900,36,5,31900,0,0,0,
G3600050032300,36,5,32300,0,321,321,0
G3600050032400,36,5,32400,221,192,413,0.53510898
G3600050032600,36,5,32600,14,253,267,0.052434456
G3600050032800,36,5,32800,183,358,541,0.33826247
G3600050033000,36,5,33000,118,279,397,0.29722923
G3600050033201,36,5,33201,157,296,453,0.34657836
G3600050033202,36,5,33202,81,323,404,0.20049505
G3600050033400,36,5,33400,15,104,119,0.12605043
G3600050033500,36,5,33500,0,94,94,0
G3600050033600,36,5,33600,332,521,853,0.38921455
G3600050033700,36,5,33700,0,179,179,0
G3600050033800,36,5,33800,190,250,440,0.43181819
G3600050034000,36,5,34000,187,406,593,0.3153457
G3600050034200,36,5,34200,59,148,207,0.28502417
G3600050034300,36,5,34300,52,169,221,0.23529412
G3600050034400,36,5,34400,34,163,197,0.17258883
G3600050034500,36,5,34500,60,239,299,0.2006689
G3600050034800,36,5,34800,277,614,891,0.31088665
G3600050035000,36,5,35000,70,185,255,0.27450982
G3600050035100,36,5,35100,52,155,207,0.25120774
G3600050035600,36,5,35600,12,219,231,0.051948052
G3600050035800,36,5,35800,66,698,764,0.086387433
G3600050035900,36,5,35900,126,114,240,0.52499998
G3600050036000,36,5,36000,25,249,274,0.091240875
G3600050036100,36,5,36100,355,442,797,0.44542032
G3600050036300,36,5,36300,630,413,1043,0.60402685
G3600050036400,36,5,36400,12,246,258,0.046511628
G3600050036501,36,5,36501,373,212,585,0.63760686
G3600050036502,36,5,36502,134,105,239,0.56066948
G3600050036700,36,5,36700,191,118,309,0.61812299
G3600050036800,36,5,36800,20,199,219,0.091324203
G3600050036901,36,5,36901,191,89,280,0.68214285
G3600050036902,36,5,36902,150,98,248,0.60483873
G3600050037000,36,5,37000,40,208,248,0.16129032
G3600050037100,36,5,37100,82,264,346,0.23699422
G3600050037200,36,5,37200,76,84,160,0.47499999
G3600050037300,36,5,37300,325,377,702,0.46296296
G3600050037400,36,5,37400,178,237,415,0.42891565
G3600050037504,36,5,37504,306,199,505,0.60594058
G3600050037600,36,5,37600,32,297,329,0.097264439
G3600050037800,36,5,37800,81,307,388,0.20876288
G3600050037900,36,5,37900,343,327,670,0.5119403
G3600050038000,36,5,38000,222,322,544,0.40808824
G3600050038100,36,5,38100,299,530,829,0.36067551
G3600050038200,36,5,38200,107,239,346,0.30924857
G3600050038301,36,5,38301,245,300,545,0.44954127
G3600050038302,36,5,38302,500,231,731,0.68399453
G3600050038500,36,5,38500,324,341,665,0.48721805
G3600050038600,36,5,38600,77,697,774,0.099483207
G3600050038700,36,5,38700,303,171,474,0.6392405
G3600050038800,36,5,38800,77,257,334,0.23053892
G3600050038900,36,5,38900,321,317,638,0.50313479
G3600050039000,36,5,39000,144,161,305,0.47213113
G3600050039100,36,5,39100,414,541,955,0.43350786
G3600050039200,36,5,39200,91,161,252,0.3611111
G3600050039300,36,5,39300,483,537,1020,0.4735294
G3600050039400,36,5,39400,188,324,512,0.3671875
G3600050039500,36,5,39500,170,298,468,0.36324787
G3600050039600,36,5,39600,143,319,462,0.30952382
G3600050039700,36,5,39700,93,70,163,0.57055217
G3600050039800,36,5,39800,61,218,279,0.21863799
G3600050039901,36,5,39901,399,278,677,0.58936483
G3600050039902,36,5,39902,261,320,581,0.44922549
G3600050040100,36,5,40100,310,342,652,0.47546011
G3600050040302,36,5,40302,315,258,573,0.54973823
G3600050040303,36,5,40303,87,286,373,0.23324397
G3600050040304,36,5,40304,136,299,435,0.31264368
G3600050040400,36,5,40400,33,238,271,0.12177122
G3600050040501,36,5,40501,168,281,449,0.37416482
G3600050040502,36,5,40502,273,319,592,0.46114865
G3600050040600,36,5,40600,74,166,240,0.30833334
G3600050040701,36,5,40701,234,187,421,0.55581945
G3600050040702,36,5,40702,370,504,874,0.42334095
G3600050040800,36,5,40800,205,367,572,0.35839161
G3600050040900,36,5,40900,95,217,312,0.30448717
G3600050041100,36,5,41100,75,255,330,0.22727273
G3600050041300,36,5,41300,229,545,774,0.29586563
G3600050041400,36,5,41400,81,367,448,0.18080357
G3600050041500,36,5,41500,196,408,604,0.3245033
G3600050041800,36,5,41800,266,183,449,0.59242761
G3600050041900,36,5,41900,234,532,766,0.30548304
G3600050042000,36,5,42000,77,321,398,0.19346733
G3600050042100,36,5,42100,187,365,552,0.33876812
G3600050042200,36,5,42200,47,301,348,0.13505746
G3600050042300,36,5,42300,261,323,584,0.4469178
G3600050042400,36,5,42400,41,228,269,0.15241636
G3600050042500,36,5,42500,339,402,741,0.45748988
G3600050042600,36,5,42600,195,676,871,0.2238806
G3600050042800,36,5,42800,23,141,164,0.1402439
G3600050042901,36,5,42901,159,253,412,0.38592234
G3600050042902,36,5,42902,233,322,555,0.41981983
G3600050043000,36,5,43000,0,316,316,0
G3600050043100,36,5,43100,338,612,950,0.35578948
G3600050043400,36,5,43400,88,393,481,0.18295218
G3600050043500,36,5,43500,0,9,9,0
G3600050043600,36,5,43600,61,262,323,0.18885449
G3600050044200,36,5,44200,127,194,321,0.39563861
G3600050044400,36,5,44400,52,321,373,0.13941018
G3600050044800,36,5,44800,22,189,211,0.1042654
G3600050044901,36,5,44901,6,52,58,0.10344828
G3600050044902,36,5,44902,12,123,135,0.088888891
G3600050045101,36,5,45101,2,65,67,0.029850746
G3600050045102,36,5,45102,4,122,126,0.031746034
G3600050045600,36,5,45600,8,256,264,0.030303031
G3600050045800,36,5,45800,563,241,804,0.70024878
G3600050046000,36,5,46000,144,271,415,0.34698796
G3600050046201,36,5,46201,109,2208,2317,0.047043592
G3600050046202,36,5,46202,260,947,1207,0.21541011
G3600050048400,36,5,48400,29,472,501,0.057884231
G3600050050400,36,5,50400,0,7,7,0
G3600050051600,36,5,51600,0,386,386,0
G3600070000100,36,7,100,45,101,146,0.30821916
G3600070000200,36,7,200,101,122,223,0.4529148
G3600070000300,36,7,300,46,145,191,0.24083769
G3600070000400,36,7,400,73,122,195,0.37435898
G3600070000500,36,7,500,71,80,151,0.47019866
G3600070000600,36,7,600,86,175,261,0.32950193
G3600070000700,36,7,700,117,194,311,0.3762058
G3600070000900,36,7,900,64,78,142,0.45070422
G3600070001100,36,7,1100,82,48,130,0.63076925
G3600070001200,36,7,1200,0,5,5,0
G3600070001300,36,7,1300,60,66,126,0.47619048
G3600070001400,36,7,1400,60,169,229,0.26200873
G3600070001500,36,7,1500,12,372,384,0.03125
G3600070001600,36,7,1600,14,99,113,0.1238938
G3600070001700,36,7,1700,130,168,298,0.4362416
G3600070001800,36,7,1800,174,142,316,0.55063289
G3600070010200,36,7,10200,46,412,458,0.10043668
G3600070011901,36,7,11901,49,221,270,0.18148148
G3600070011902,36,7,11902,47,231,278,0.16906475
G3600070011903,36,7,11903,32,240,272,0.11764706
G3600070012000,36,7,12000,38,112,150,0.25333333
G3600070012101,36,7,12101,107,306,413,0.2590799
G3600070012102,36,7,12102,8,392,400,0.02
G3600070012103,36,7,12103,8,221,229,0.034934498
G3600070012201,36,7,12201,30,176,206,0.14563107
G3600070012202,36,7,12202,90,228,318,0.28301886
G3600070012300,36,7,12300,156,327,483,0.32298136
G3600070012400,36,7,12400,33,194,227,0.14537445
G3600070012500,36,7,12500,50,556,606,0.082508251
G3600070012600,36,7,12600,35,463,498,0.070281126
G3600070012701,36,7,12701,99,504,603,0.1641791
G3600070012702,36,7,12702,30,459,489,0.061349694
G3600070012800,36,7,12800,153,328,481,0.31808731
G3600070012900,36,7,12900,0,83,83,0
G3600070013000,36,7,13000,23,354,377,0.061007958
G3600070013100,36,7,13100,78,305,383,0.20365535
G3600070013201,36,7,13201,23,202,225,0.10222222
G3600070013202,36,7,13202,26,227,253,0.1027668
G3600070013301,36,7,13301,23,382,405,0.056790125
G3600070013303,36,7,13303,16,222,238,0.067226894
G3600070013304,36,7,13304,11,540,551,0.019963702
G3600070013400,36,7,13400,118,339,457,0.25820568
G3600070013500,36,7,13500,72,86,158,0.4556962
G3600070013600,36,7,13600,110,182,292,0.37671232
G3600070013700,36,7,13700,72,180,252,0.2857143
G3600070013800,36,7,13800,0,293,293,0
G3600070013900,36,7,13900,46,130,176,0.26136363
G3600070014000,36,7,14000,46,139,185,0.24864864
G3600070014100,36,7,14100,63,244,307,0.20521173
G3600070014200,36,7,14200,0,185,185,0
G3600070014301,36,7,14301,130,297,427,0.30444965
G3600070014302,36,7,14302,20,175,195,0.1025641
G3600070014400,36,7,14400,14,324,338,0.041420117
G3600070014500,36,7,14500,0,381,381,0
G3600070014600,36,7,14600,47,489,536,0.087686568
G3600090940000,36,9,940000,30,19,49,0.6122449
G3600090940200,36,9,940200,0,0,0,
G3600090940300,36,9,940300,216,449,665,0.32481202
G3600090960100,36,9,960100,74,262,336,0.22023809
G3600090960200,36,9,960200,26,349,375,0.06933333
G3600090960300,36,9,960300,16,379,395,0.040506329
G3600090960400,36,9,960400,106,280,386,0.27461141
G3600090960500,36,9,960500,140,400,540,0.25925925
G3600090960600,36,9,960600,80,230,310,0.25806451
G3600090960702,36,9,960702,47,162,209,0.22488038
G3600090960800,36,9,960800,66,392,458,0.14410481
G3600090961000,36,9,961000,124,358,482,0.25726143
G3600090961100,36,9,961100,54,286,340,0.15882353
G3600090961200,36,9,961200,56,271,327,0.17125382
G3600090961300,36,9,961300,73,279,352,0.20738636
G3600090961400,36,9,961400,82,342,424,0.19339623
G3600090961500,36,9,961500,37,131,168,0.22023809
G3600090961600,36,9,961600,36,300,336,0.10714286
G3600090961700,36,9,961700,294,117,411,0.71532845
G3600090961800,36,9,961800,76,321,397,0.19143577
G3600090962200,36,9,962200,91,208,299,0.30434781
G3600110040100,36,11,40100,108,407,515,0.20970874
G3600110040200,36,11,40200,24,432,456,0.052631579
G3600110040300,36,11,40300,68,319,387,0.17571059
G3600110040400,36,11,40400,82,420,502,0.16334662
G3600110040500,36,11,40500,46,249,295,0.1559322
G3600110040600,36,11,40600,8,330,338,0.023668639
G3600110040700,36,11,40700,16,386,402,0.039800994
G3600110040800,36,11,40800,34,360,394,0.086294413
G3600110040900,36,11,40900,89,285,374,0.23796791
G3600110041000,36,11,41000,95,324,419,0.22673032
G3600110041100,36,11,41100,15,347,362,0.041436464
G3600110041200,36,11,41200,60,452,512,0.1171875
G3600110041300,36,11,41300,156,290,446,0.34977579
G3600110041400,36,11,41400,33,233,266,0.12406015
G3600110041500,36,11,41500,64,245,309,0.20711975
G3600110041600,36,11,41600,11,217,228,0.048245613
G3600110041700,36,11,41700,96,267,363,0.2644628
G3600110041800,36,11,41800,39,386,425,0.091764703
G3600110042100,36,11,42100,154,175,329,0.46808511
G3600110990200,36,11,990200,0,0,0,
G3600130030100,36,13,30100,220,179,399,0.55137843
G3600130030200,36,13,30200,81,277,358,0.22625698
G3600130030300,36,13,30300,108,83,191,0.56544501
G3600130030400,36,13,30400,22,345,367,0.059945505
G3600130030500,36,13,30500,216,159,375,0.57599998
G3600130030600,36,13,30600,161,201,362,0.44475138
G3600130030700,36,13,30700,251,321,572,0.43881118
G3600130030800,36,13,30800,156,330,486,0.32098764
G3600130035100,36,13,35100,50,342,392,0.12755102
G3600130035300,36,13,35300,47,205,252,0.18650794
G3600130035400,36,13,35400,117,215,332,0.35240963
G3600130035500,36,13,35500,48,238,286,0.16783217
G3600130035600,36,13,35600,100,228,328,0.30487806
G3600130035700,36,13,35700,200,194,394,0.5076142
G3600130035800,36,13,35800,0,190,190,0
G3600130035901,36,13,35901,27,391,418,0.0645933
G3600130035902,36,13,35902,5,14,19,0.2631579
G3600130036000,36,13,36000,5,310,315,0.015873017
G3600130036100,36,13,36100,90,347,437,0.20594966
G3600130036300,36,13,36300,63,258,321,0.19626169
G3600130036401,36,13,36401,25,156,181,0.13812155
G3600130036402,36,13,36402,163,176,339,0.48082596
G3600130036500,36,13,36500,89,352,441,0.20181406
G3600130036600,36,13,36600,91,203,294,0.30952382
G3600130036700,36,13,36700,89,306,395,0.22531645
G3600130036800,36,13,36800,96,337,433,0.22170901
G3600130036901,36,13,36901,21,231,252,0.083333336
G3600130036902,36,13,36902,4,223,227,0.017621145
G3600130037000,36,13,37000,42,242,284,0.14788732
G3600130037100,36,13,37100,101,311,412,0.24514563
G3600130037200,36,13,37200,26,223,249,0.10441767
G3600130037300,36,13,37300,130,418,548,0.23722628
G3600130037400,36,13,37400,36,256,292,0.12328767
G3600130037500,36,13,37500,96,454,550,0.17454545
G3600130037600,36,13,37600,100,157,257,0.38910505
G3600130990000,36,13,990000,0,0,0,
G3600150000100,36,15,100,224,168,392,0.5714286
G3600150000200,36,15,200,183,160,343,0.53352767
G3600150000300,36,15,300,0,0,0,
G3600150000400,36,15,400,64,140,204,0.3137255
G3600150000500,36,15,500,42,250,292,0.14383562
G3600150000600,36,15,600,138,120,258,0.53488374
G3600150000700,36,15,700,66,65,131,0.50381678
G3600150000900,36,15,900,117,326,443,0.26410836
G3600150001000,36,15,1000,239,116,355,0.67323941
G3600150001100,36,15,1100,45,214,259,0.17374517
G3600150010100,36,15,10100,49,333,382,0.12827225
G3600150010200,36,15,10200,64,399,463,0.13822894
G3600150010300,36,15,10300,42,631,673,0.062407132
G3600150010400,36,15,10400,2,274,276,0.007246377
G3600150010500,36,15,10500,88,228,316,0.27848101
G3600150010600,36,15,10600,8,258,266,0.030075189
G3600150010700,36,15,10700,10,720,730,0.01369863
G3600150010800,36,15,10800,89,215,304,0.29276314
G3600150010900,36,15,10900,0,542,542,0
G3600150011000,36,15,11000,25,328,353,0.070821531
G3600150011100,36,15,11100,131,511,642,0.20404984
G3600150011200,36,15,11200,77,352,429,0.17948718
G3600170970100,36,17,970100,134,461,595,0.22521009
G3600170970200,36,17,970200,89,295,384,0.23177083
G3600170970300,36,17,970300,27,283,310,0.087096773
G3600170970400,36,17,970400,126,185,311,0.40514469
G3600170970500,36,17,970500,119,462,581,0.20481928
G3600170970601,36,17,970601,115,275,390,0.29487181
G3600170970602,36,17,970602,52,252,304,0.17105263
G3600170970700,36,17,970700,41,174,215,0.19069767
G3600170970801,36,17,970801,22,305,327,0.067278288
G3600170970802,36,17,970802,112,303,415,0.26987952
G3600170970900,36,17,970900,67,318,385,0.17402597
G3600170971000,36,17,971000,73,256,329,0.2218845
G3600190100100,36,19,100100,144,458,602,0.23920266
G3600190100200,36,19,100200,61,433,494,0.12348178
G3600190100300,36,19,100300,126,637,763,0.16513762
G3600190100400,36,19,100400,116,286,402,0.2885572
G3600190100600,36,19,100600,69,421,490,0.14081633
G3600190100700,36,19,100700,0,314,314,0
G3600190100800,36,19,100800,31,392,423,0.073286049
G3600190100900,36,19,100900,32,319,351,0.091168091
G3600190101000,36,19,101000,24,273,297,0.080808081
G3600190101100,36,19,101100,0,16,16,0
G3600190101300,36,19,101300,100,129,229,0.43668121
G3600190101400,36,19,101400,10,182,192,0.052083332
G3600190101600,36,19,101600,51,131,182,0.28021979
G3600190101700,36,19,101700,134,472,606,0.22112212
G3600190101800,36,19,101800,109,514,623,0.17495987
G3600190101900,36,19,101900,135,570,705,0.19148937
G3600190102000,36,19,102000,53,273,326,0.16257669
G3600190102100,36,19,102100,29,161,190,0.15263158
G3600190102200,36,19,102200,207,147,354,0.58474576
G3600210000100,36,21,100,12,206,218,0.055045873
G3600210000200,36,21,200,8,124,132,0.060606062
G3600210000300,36,21,300,54,251,305,0.17704917
G3600210000401,36,21,401,4,173,177,0.02259887
G3600210000402,36,21,402,7,587,594,0.011784512
G3600210000500,36,21,500,63,164,227,0.27753305
G3600210000600,36,21,600,12,243,255,0.047058824
G3600210000700,36,21,700,34,468,502,0.067729086
G3600210000800,36,21,800,17,96,113,0.15044248
G3600210000900,36,21,900,0,113,113,0
G3600210001000,36,21,1000,100,350,450,0.22222222
G3600210001100,36,21,1100,30,315,345,0.086956523
G3600210001200,36,21,1200,125,247,372,0.33602151
G3600210001300,36,21,1300,12,145,157,0.076433122
G3600210001400,36,21,1400,10,241,251,0.039840639
G3600210001500,36,21,1500,21,44,65,0.32307693
G3600210001600,36,21,1600,38,300,338,0.11242604
G3600210001700,36,21,1700,30,80,110,0.27272728
G3600210001800,36,21,1800,18,145,163,0.11042945
G3600210001900,36,21,1900,31,158,189,0.16402116
G3600210002000,36,21,2000,12,191,203,0.059113301
G3600230970100,36,23,970100,57,280,337,0.16913946
G3600230970200,36,23,970200,51,537,588,0.086734697
G3600230970300,36,23,970300,25,298,323,0.077399381
G3600230970400,36,23,970400,43,204,247,0.17408907
G3600230970500,36,23,970500,19,270,289,0.065743946
G3600230970600,36,23,970600,59,198,257,0.22957198
G3600230970700,36,23,970700,36,338,374,0.096256681
G3600230970800,36,23,970800,0,3,3,0
G3600230970900,36,23,970900,132,251,383,0.34464753
G3600230971000,36,23,971000,0,466,466,0
G3600230971100,36,23,971100,88,458,546,0.16117217
G3600230971200,36,23,971200,7,339,346,0.020231213
G3600250970100,36,25,970100,79,288,367,0.21525885
G3600250970200,36,25,970200,17,142,159,0.10691824
G3600250970300,36,25,970300,21,219,240,0.087499999
G3600250970400,36,25,970400,82,357,439,0.18678816
G3600250970500,36,25,970500,47,322,369,0.12737127
G3600250970600,36,25,970600,215,296,511,0.42074364
G3600250970700,36,25,970700,43,163,206,0.20873787
G3600250970800,36,25,970800,18,176,194,0.092783503
G3600250970900,36,25,970900,0,0,0,
G3600250971000,36,25,971000,91,168,259,0.35135135
G3600250971100,36,25,971100,49,185,234,0.20940171
G3600250971200,36,25,971200,66,252,318,0.20754717
G3600250971300,36,25,971300,75,86,161,0.46583852
G3600250971400,36,25,971400,3,168,171,0.01754386
G3600270010000,36,27,10000,0,355,355,0
G3600270020003,36,27,20003,27,471,498,0.054216869
G3600270020004,36,27,20004,41,266,307,0.13355049
G3600270020005,36,27,20005,0,668,668,0
G3600270030000,36,27,30000,64,422,486,0.13168724
G3600270040001,36,27,40001,43,436,479,0.089770354
G3600270040003,36,27,40003,108,275,383,0.28198433
G3600270050102,36,27,50102,0,361,361,0
G3600270050103,36,27,50103,42,578,620,0.067741938
G3600270050104,36,27,50104,38,805,843,0.045077104
G3600270050203,36,27,50203,25,602,627,0.039872408
G3600270050204,36,27,50204,9,341,350,0.025714286
G3600270050205,36,27,50205,0,629,629,0
G3600270060100,36,27,60100,120,292,412,0.29126215
G3600270060201,36,27,60201,18,240,258,0.069767445
G3600270060202,36,27,60202,72,321,393,0.18320611
G3600270060301,36,27,60301,26,463,489,0.053169735
G3600270060302,36,27,60302,0,290,290,0
G3600270060400,36,27,60400,29,161,190,0.15263158
G3600270070101,36,27,70101,32,261,293,0.10921501
G3600270070102,36,27,70102,55,216,271,0.20295203
G3600270070201,36,27,70201,39,231,270,0.14444445
G3600270070301,36,27,70301,136,503,639,0.21283256
G3600270070401,36,27,70401,21,245,266,0.078947365
G3600270080103,36,27,80103,29,573,602,0.048172757
G3600270080104,36,27,80104,0,335,335,0
G3600270080201,36,27,80201,16,533,549,0.029143898
G3600270080202,36,27,80202,28,287,315,0.088888891
G3600270090000,36,27,90000,6,197,203,0.029556651
G3600270100000,36,27,100000,0,256,256,0
G3600270110003,36,27,110003,0,472,472,0
G3600270110004,36,27,110004,29,187,216,0.13425925
G3600270110005,36,27,110005,21,176,197,0.10659899
G3600270120000,36,27,120000,12,240,252,0.047619049
G3600270130003,36,27,130003,23,408,431,0.053364269
G3600270130004,36,27,130004,0,122,122,0
G3600270130005,36,27,130005,54,224,278,0.19424461
G3600270140101,36,27,140101,58,296,354,0.16384181
G3600270140200,36,27,140200,115,642,757,0.15191546
G3600270140300,36,27,140300,35,402,437,0.080091536
G3600270140400,36,27,140400,0,617,617,0
G3600270140500,36,27,140500,69,235,304,0.22697368
G3600270140602,36,27,140602,55,261,316,0.17405063
G3600270140700,36,27,140700,32,616,648,0.049382716
G3600270140801,36,27,140801,104,215,319,0.32601881
G3600270150003,36,27,150003,0,105,105,0
G3600270150004,36,27,150004,36,435,471,0.076433122
G3600270150005,36,27,150005,10,304,314,0.031847134
G3600270150006,36,27,150006,0,150,150,0
G3600270160003,36,27,160003,0,129,129,0
G3600270160004,36,27,160004,0,162,162,0
G3600270160005,36,27,160005,76,163,239,0.31799164
G3600270170000,36,27,170000,18,235,253,0.071146242
G3600270180001,36,27,180001,0,443,443,0
G3600270190101,36,27,190101,0,367,367,0
G3600270190102,36,27,190102,10,129,139,0.071942449
G3600270190203,36,27,190203,19,247,266,0.071428575
G3600270190204,36,27,190204,20,502,522,0.038314175
G3600270190301,36,27,190301,0,254,254,0
G3600270190401,36,27,190401,17,210,227,0.074889868
G3600270190402,36,27,190402,34,357,391,0.086956523
G3600270200001,36,27,200001,0,222,222,0
G3600270200002,36,27,200002,0,142,142,0
G3600270210101,36,27,210101,186,316,502,0.37051794
G3600270210201,36,27,210201,90,276,366,0.24590164
G3600270210301,36,27,210301,29,335,364,0.079670332
G3600270220100,36,27,220100,79,261,340,0.23235294
G3600270220201,36,27,220201,90,200,290,0.31034482
G3600270220300,36,27,220300,255,285,540,0.47222221
G3600270220700,36,27,220700,72,199,271,0.26568267
G3600270220801,36,27,220801,185,223,408,0.45343137
G3600270220901,36,27,220901,47,353,400,0.1175
G3600270221001,36,27,221001,32,150,182,0.17582418
G3600270221100,36,27,221100,145,225,370,0.3918919
G3600270300000,36,27,300000,116,415,531,0.21845575
G3600270410000,36,27,410000,22,185,207,0.10628019
G3600270610000,36,27,610000,0,0,0,
G3600270640001,36,27,640001,0,0,0,
G3600270640002,36,27,640002,0,0,0,
G3600290000110,36,29,110,96,218,314,0.30573249
G3600290000200,36,29,200,223,328,551,0.4047187
G3600290000500,36,29,500,76,86,162,0.46913579
G3600290000600,36,29,600,71,346,417,0.17026378
G3600290000700,36,29,700,24,304,328,0.073170729
G3600290000800,36,29,800,133,344,477,0.278826
G3600290000900,36,29,900,28,191,219,0.12785389
G3600290001000,36,29,1000,137,235,372,0.36827958
G3600290001100,36,29,1100,92,118,210,0.43809524
G3600290001402,36,29,1402,168,155,323,0.52012384
G3600290001500,36,29,1500,115,91,206,0.55825245
G3600290001600,36,29,1600,146,71,217,0.67281103
G3600290001700,36,29,1700,100,71,171,0.5847953
G3600290001900,36,29,1900,0,241,241,0
G3600290002300,36,29,2300,116,198,314,0.36942676
G3600290002400,36,29,2400,194,241,435,0.445977
G3600290002502,36,29,2502,88,148,236,0.37288135
G3600290002702,36,29,2702,116,100,216,0.53703701
G3600290002800,36,29,2800,174,114,288,0.60416669
G3600290002900,36,29,2900,118,90,208,0.56730771
G3600290003000,36,29,3000,176,139,315,0.55873019
G3600290003100,36,29,3100,54,113,167,0.32335329
G3600290003301,36,29,3301,303,336,639,0.4741784
G3600290003302,36,29,3302,167,144,311,0.53697747
G3600290003400,36,29,3400,80,165,245,0.32653061
G3600290003500,36,29,3500,192,166,358,0.53631288
G3600290003600,36,29,3600,159,96,255,0.62352943
G3600290003700,36,29,3700,415,271,686,0.60495627
G3600290003800,36,29,3800,210,210,420,0.5
G3600290003901,36,29,3901,52,40,92,0.56521738
G3600290004001,36,29,4001,297,295,592,0.5016892
G3600290004100,36,29,4100,140,370,510,0.27450982
G3600290004200,36,29,4200,147,222,369,0.39837399
G3600290004300,36,29,4300,411,396,807,0.50929368
G3600290004401,36,29,4401,221,308,529,0.41776937
G3600290004402,36,29,4402,316,153,469,0.673774
G3600290004500,36,29,4500,102,293,395,0.25822785
G3600290004601,36,29,4601,33,144,177,0.18644068
G3600290004602,36,29,4602,0,0,0,
G3600290004700,36,29,4700,94,425,519,0.18111753
G3600290004800,36,29,4800,0,337,337,0
G3600290004900,36,29,4900,46,303,349,0.13180515
G3600290005000,36,29,5000,63,73,136,0.46323529
G3600290005100,36,29,5100,45,172,217,0.20737328
G3600290005201,36,29,5201,9,242,251,0.035856575
G3600290005202,36,29,5202,61,100,161,0.37888199
G3600290005300,36,29,5300,0,45,45,0
G3600290005400,36,29,5400,18,355,373,0.048257373
G3600290005500,36,29,5500,182,175,357,0.50980395
G3600290005600,36,29,5600,233,302,535,0.43551403
G3600290005700,36,29,5700,244,121,365,0.66849315
G3600290005801,36,29,5801,260,195,455,0.5714286
G3600290005802,36,29,5802,436,306,742,0.58760107
G3600290005900,36,29,5900,210,144,354,0.59322035
G3600290006100,36,29,6100,265,260,525,0.50476193
G3600290006201,36,29,6201,0,0,0,
G3600290006301,36,29,6301,97,278,375,0.25866666
G3600290006302,36,29,6302,0,185,185,0
G3600290006501,36,29,6501,47,127,174,0.27011493
G3600290006601,36,29,6601,109,166,275,0.39636365
G3600290006602,36,29,6602,0,85,85,0
G3600290006701,36,29,6701,81,118,199,0.40703517
G3600290006702,36,29,6702,17,12,29,0.58620691
G3600290006800,36,29,6800,33,81,114,0.28947368
G3600290006901,36,29,6901,318,128,446,0.71300447
G3600290006902,36,29,6902,215,174,389,0.55269921
G3600290007000,36,29,7000,196,87,283,0.69257951
G3600290007101,36,29,7101,321,276,597,0.53768843
G3600290007102,36,29,7102,221,101,322,0.68633538
G3600290007202,36,29,7202,25,106,131,0.19083969
G3600290007302,36,29,7302,152,724,876,0.17351598
G3600290007303,36,29,7303,34,576,610,0.055737704
G3600290007304,36,29,7304,23,536,559,0.0411449
G3600290007600,36,29,7600,50,208,258,0.19379845
G3600290007700,36,29,7700,0,412,412,0
G3600290007800,36,29,7800,53,344,397,0.13350126
G3600290007901,36,29,7901,0,228,228,0
G3600290007902,36,29,7902,16,409,425,0.037647057
G3600290007903,36,29,7903,10,213,223,0.044843048
G3600290007904,36,29,7904,69,245,314,0.21974522
G3600290007905,36,29,7905,69,273,342,0.20175439
G3600290008001,36,29,8001,180,448,628,0.28662419
G3600290008002,36,29,8002,112,432,544,0.20588236
G3600290008003,36,29,8003,89,398,487,0.18275154
G3600290008101,36,29,8101,44,481,525,0.083809525
G3600290008102,36,29,8102,36,346,382,0.094240837
G3600290008201,36,29,8201,11,205,216,0.050925925
G3600290008202,36,29,8202,34,244,278,0.12230216
G3600290008300,36,29,8300,138,142,280,0.49285713
G3600290008400,36,29,8400,143,83,226,0.63274336
G3600290008500,36,29,8500,6,219,225,0.026666667
G3600290008600,36,29,8600,44,362,406,0.10837439
G3600290008700,36,29,8700,90,337,427,0.21077283
G3600290008800,36,29,8800,18,220,238,0.075630255
G3600290008900,36,29,8900,26,311,337,0.077151336
G3600290009004,36,29,9004,0,387,387,0
G3600290009006,36,29,9006,0,751,751,0
G3600290009007,36,29,9007,65,879,944,0.068855934
G3600290009008,36,29,9008,0,399,399,0
G3600290009009,36,29,9009,0,525,525,0
G3600290009010,36,29,9010,76,733,809,0.093943141
G3600290009104,36,29,9104,0,440,440,0
G3600290009106,36,29,9106,16,333,349,0.045845274
G3600290009107,36,29,9107,176,468,644,0.27329192
G3600290009109,36,29,9109,0,193,193,0
G3600290009110,36,29,9110,0,0,0,
G3600290009112,36,29,9112,40,101,141,0.28368795
G3600290009113,36,29,9113,58,729,787,0.073697589
G3600290009114,36,29,9114,40,379,419,0.095465392
G3600290009115,36,29,9115,79,36,115,0.68695652
G3600290009116,36,29,9116,0,428,428,0
G3600290009200,36,29,9200,44,166,210,0.20952381
G3600290009301,36,29,9301,21,389,410,0.051219512
G3600290009302,36,29,9302,40,212,252,0.15873016
G3600290009401,36,29,9401,28,452,480,0.058333334
G3600290009402,36,29,9402,0,402,402,0
G3600290009501,36,29,9501,44,486,530,0.083018869
G3600290009502,36,29,9502,19,599,618,0.030744337
G3600290009600,36,29,9600,94,312,406,0.23152709
G3600290009701,36,29,9701,26,172,198,0.13131313
G3600290009702,36,29,9702,11,449,460,0.023913043
G3600290009800,36,29,9800,21,107,128,0.1640625
G3600290009900,36,29,9900,66,265,331,0.19939578
G3600290010001,36,29,10001,27,236,263,0.10266159
G3600290010002,36,29,10002,32,215,247,0.12955466
G3600290010003,36,29,10003,49,289,338,0.14497042
G3600290010101,36,29,10101,0,257,257,0
G3600290010102,36,29,10102,40,254,294,0.13605443
G3600290010103,36,29,10103,32,322,354,0.09039548
G3600290010201,36,29,10201,70,223,293,0.23890784
G3600290010202,36,29,10202,82,428,510,0.16078432
G3600290010300,36,29,10300,52,149,201,0.25870648
G3600290010400,36,29,10400,81,165,246,0.32926831
G3600290010500,36,29,10500,55,133,188,0.29255319
G3600290010600,36,29,10600,30,176,206,0.14563107
G3600290010700,36,29,10700,45,106,151,0.29801324
G3600290010803,36,29,10803,13,119,132,0.098484851
G3600290010804,36,29,10804,43,182,225,0.19111112
G3600290010805,36,29,10805,14,386,400,0.035
G3600290010807,36,29,10807,0,262,262,0
G3600290010808,36,29,10808,47,241,288,0.16319445
G3600290010809,36,29,10809,0,237,237,0
G3600290010901,36,29,10901,19,130,149,0.12751678
G3600290010902,36,29,10902,54,212,266,0.20300752
G3600290011000,36,29,11000,56,129,185,0.3027027
G3600290011100,36,29,11100,0,183,183,0
G3600290011200,36,29,11200,40,574,614,0.06514658
G3600290011300,36,29,11300,99,407,506,0.19565217
G3600290011400,36,29,11400,23,185,208,0.11057692
G3600290011500,36,29,11500,17,158,175,0.09714286
G3600290011600,36,29,11600,0,131,131,0
G3600290011700,36,29,11700,9,259,268,0.033582091
G3600290011800,36,29,11800,8,363,371,0.021563342
G3600290012001,36,29,12001,73,478,551,0.13248639
G3600290012002,36,29,12002,50,327,377,0.132626
G3600290012003,36,29,12003,10,419,429,0.023310022
G3600290012300,36,29,12300,48,170,218,0.22018349
G3600290012400,36,29,12400,89,96,185,0.48108107
G3600290012501,36,29,12501,56,218,274,0.20437956
G3600290012502,36,29,12502,15,55,70,0.21428572
G3600290012800,36,29,12800,68,186,254,0.26771653
G3600290012901,36,29,12901,20,419,439,0.045558088
G3600290012902,36,29,12902,0,204,204,0
G3600290013001,36,29,13001,58,238,296,0.19594595
G3600290013002,36,29,13002,33,403,436,0.075688072
G3600290013101,36,29,13101,86,459,545,0.15779817
G3600290013102,36,29,13102,49,905,954,0.051362682
G3600290013201,36,29,13201,86,466,552,0.15579709
G3600290013202,36,29,13202,16,525,541,0.029574862
G3600290013300,36,29,13300,29,364,393,0.073791347
G3600290013400,36,29,13400,0,628,628,0
G3600290013501,36,29,13501,12,620,632,0.018987341
G3600290013502,36,29,13502,14,868,882,0.015873017
G3600290013600,36,29,13600,16,315,331,0.048338369
G3600290013701,36,29,13701,16,613,629,0.025437202
G3600290013702,36,29,13702,15,680,695,0.021582734
G3600290013800,36,29,13800,66,633,699,0.094420604
G3600290013900,36,29,13900,27,266,293,0.092150174
G3600290014000,36,29,14000,0,399,399,0
G3600290014101,36,29,14101,16,536,552,0.028985508
G3600290014102,36,29,14102,0,407,407,0
G3600290014204,36,29,14204,20,267,287,0.069686413
G3600290014206,36,29,14206,26,1125,1151,0.022589052
G3600290014207,36,29,14207,0,422,422,0
G3600290014208,36,29,14208,0,582,582,0
G3600290014209,36,29,14209,0,454,454,0
G3600290014300,36,29,14300,0,577,577,0
G3600290014400,36,29,14400,75,316,391,0.19181585
G3600290014501,36,29,14501,34,255,289,0.11764706
G3600290014502,36,29,14502,59,144,203,0.29064038
G3600290014601,36,29,14601,16,492,508,0.031496063
G3600290014603,36,29,14603,0,492,492,0
G3600290014604,36,29,14604,0,1029,1029,0
G3600290014701,36,29,14701,34,593,627,0.054226477
G3600290014702,36,29,14702,47,746,793,0.059268601
G3600290014801,36,29,14801,0,194,194,0
G3600290014803,36,29,14803,0,587,587,0
G3600290014901,36,29,14901,59,220,279,0.21146953
G3600290014903,36,29,14903,100,572,672,0.14880952
G3600290014904,36,29,14904,0,0,0,
G3600290015001,36,29,15001,40,519,559,0.071556352
G3600290015002,36,29,15002,27,288,315,0.085714288
G3600290015003,36,29,15003,67,296,363,0.18457301
G3600290015101,36,29,15101,29,290,319,0.090909094
G3600290015102,36,29,15102,12,291,303,0.03960396
G3600290015201,36,29,15201,0,219,219,0
G3600290015202,36,29,15202,0,475,475,0
G3600290015301,36,29,15301,11,432,443,0.024830699
G3600290015302,36,29,15302,14,221,235,0.05957447
G3600290015401,36,29,15401,0,220,220,0
G3600290015402,36,29,15402,49,375,424,0.11556604
G3600290015501,36,29,15501,36,158,194,0.18556701
G3600290015503,36,29,15503,18,130,148,0.12162162
G3600290015504,36,29,15504,45,348,393,0.11450382
G3600290015600,36,29,15600,33,150,183,0.18032786
G3600290015700,36,29,15700,3,256,259,0.011583012
G3600290015800,36,29,15800,21,378,399,0.052631579
G3600290015900,36,29,15900,55,360,415,0.13253012
G3600290016100,36,29,16100,0,4,4,0
G3600290016200,36,29,16200,23,105,128,0.1796875
G3600290016300,36,29,16300,146,162,308,0.47402596
G3600290016400,36,29,16400,80,287,367,0.21798365
G3600290016500,36,29,16500,0,0,0,
G3600290016600,36,29,16600,119,152,271,0.43911439
G3600290016700,36,29,16700,46,108,154,0.29870129
G3600290016800,36,29,16800,183,208,391,0.46803069
G3600290016900,36,29,16900,63,233,296,0.21283785
G3600290017000,36,29,17000,98,212,310,0.31612903
G3600290017100,36,29,17100,387,156,543,0.71270716
G3600290017200,36,29,17200,77,192,269,0.28624535
G3600290017300,36,29,17300,0,502,502,0
G3600290017400,36,29,17400,209,268,477,0.43815514
G3600290017501,36,29,17501,54,99,153,0.35294119
G3600290017502,36,29,17502,5,145,150,0.033333335
G3600290940000,36,29,940000,60,124,184,0.32608697
G3600290940100,36,29,940100,0,3,3,0
G3600290990000,36,29,990000,0,0,0,
G3600310960100,36,31,960100,13,258,271,0.047970481
G3600310960200,36,31,960200,5,273,278,0.017985612
G3600310960300,36,31,960300,40,301,341,0.11730205
G3600310960498,36,31,960498,0,162,162,0
G3600310960598,36,31,960598,38,438,476,0.079831935
G3600310960700,36,31,960700,24,149,173,0.13872832
G3600310960800,36,31,960800,6,126,132,0.045454547
G3600310960900,36,31,960900,23,237,260,0.088461541
G3600310961000,36,31,961000,64,345,409,0.15647922
G3600310961100,36,31,961100,24,161,185,0.12972973
G3600310961200,36,31,961200,114,380,494,0.23076923
G3600310961300,36,31,961300,11,49,60,0.18333334
G3600310961400,36,31,961400,7,65,72,0.097222224
G3600330940000,36,33,940000,165,220,385,0.42857143
G3600330950100,36,33,950100,72,308,380,0.18947369
G3600330950200,36,33,950200,97,397,494,0.19635628
G3600330950300,36,33,950300,141,389,530,0.26603773
G3600330950400,36,33,950400,92,404,496,0.18548387
G3600330950501,36,33,950501,184,186,370,0.49729729
G3600330950502,36,33,950502,24,100,124,0.19354838
G3600330950600,36,33,950600,32,114,146,0.21917808
G3600330950700,36,33,950700,71,159,230,0.30869564
G3600330950800,36,33,950800,12,112,124,0.096774191
G3600330950900,36,33,950900,72,286,358,0.20111732
G3600330951000,36,33,951000,43,132,175,0.24571429
G3600330951100,36,33,951100,44,321,365,0.12054794
G3600330951200,36,33,951200,6,196,202,0.029702971
G3600350970100,36,35,970100,49,184,233,0.21030043
G3600350970200,36,35,970200,70,269,339,0.20648968
G3600350970300,36,35,970300,101,229,330,0.30606061
G3600350970400,36,35,970400,15,131,146,0.10273973
G3600350970500,36,35,970500,54,275,329,0.16413374
G3600350970600,36,35,970600,172,496,668,0.25748503
G3600350970700,36,35,970700,197,168,365,0.53972602
G3600350970800,36,35,970800,90,175,265,0.33962265
G3600350970900,36,35,970900,175,193,368,0.47554347
G3600350971000,36,35,971000,64,171,235,0.27234042
G3600350971100,36,35,971100,107,101,208,0.51442307
G3600350971200,36,35,971200,26,317,343,0.075801753
G3600350971300,36,35,971300,101,476,577,0.17504333
G3600350971400,36,35,971400,15,304,319,0.047021944
G3600350971500,36,35,971500,60,466,526,0.11406844
G3600370940100,36,37,940100,33,21,54,0.6111111
G3600370950100,36,37,950100,97,430,527,0.18406072
G3600370950200,36,37,950200,39,489,528,0.073863633
G3600370950300,36,37,950300,110,523,633,0.17377567
G3600370950400,36,37,950400,75,474,549,0.13661203
G3600370950500,36,37,950500,13,263,276,0.047101449
G3600370950600,36,37,950600,115,154,269,0.42750931
G3600370950700,36,37,950700,117,108,225,0.51999998
G3600370950800,36,37,950800,82,113,195,0.42051283
G3600370950900,36,37,950900,21,168,189,0.11111111
G3600370951000,36,37,951000,94,145,239,0.39330545
G3600370951100,36,37,951100,33,428,461,0.071583517
G3600370951200,36,37,951200,30,424,454,0.066079296
G3600370951300,36,37,951300,116,316,432,0.26851851
G3600370951400,36,37,951400,66,541,607,0.10873146
G3600390080100,36,39,80100,0,174,174,0
G3600390080201,36,39,80201,35,307,342,0.10233918
G3600390080202,36,39,80202,47,154,201,0.23383084
G3600390080300,36,39,80300,18,168,186,0.096774191
G3600390080401,36,39,80401,16,107,123,0.1300813
G3600390080402,36,39,80402,9,77,86,0.10465116
G3600390080501,36,39,80501,12,170,182,0.065934069
G3600390080502,36,39,80502,151,296,447,0.3378076
G3600390080600,36,39,80600,73,269,342,0.2134503
G3600390080700,36,39,80700,33,152,185,0.17837837
G3600390080800,36,39,80800,0,0,0,
G3600390080900,36,39,80900,56,274,330,0.16969697
G3600390081000,36,39,81000,103,380,483,0.21325052
G3600390081101,36,39,81101,53,288,341,0.15542522
G3600390081102,36,39,81102,17,234,251,0.067729086
G3600410950100,36,41,950100,10,29,39,0.25641027
G3600410950300,36,41,950300,0,58,58,0
G3600410950400,36,41,950400,10,58,68,0.14705883
G3600410950500,36,41,950500,6,28,34,0.17647059
G3600430010100,36,43,10100,63,521,584,0.10787671
G3600430010201,36,43,10201,55,254,309,0.17799352
G3600430010202,36,43,10202,38,324,362,0.10497238
G3600430010300,36,43,10300,122,393,515,0.23689321
G3600430010400,36,43,10400,146,170,316,0.46202531
G3600430010501,36,43,10501,35,184,219,0.15981735
G3600430010502,36,43,10502,30,172,202,0.14851485
G3600430010701,36,43,10701,12,221,233,0.051502146
G3600430010702,36,43,10702,48,130,178,0.26966292
G3600430010900,36,43,10900,29,255,284,0.10211267
G3600430011001,36,43,11001,87,207,294,0.29591838
G3600430011002,36,43,11002,53,284,337,0.15727003
G3600430011100,36,43,11100,20,92,112,0.17857143
G3600430011200,36,43,11200,105,327,432,0.24305555
G3600430011301,36,43,11301,17,94,111,0.15315315
G3600430011302,36,43,11302,47,238,285,0.16491228
G3600430011400,36,43,11400,48,371,419,0.11455847
G3600430011501,36,43,11501,48,300,348,0.13793103
G3600430011502,36,43,11502,0,88,88,0
G3600450060100,36,45,60100,55,306,361,0.15235457
G3600450060200,36,45,60200,103,423,526,0.19581749
G3600450060300,36,45,60300,31,248,279,0.11111111
G3600450060400,36,45,60400,144,792,936,0.15384616
G3600450060500,36,45,60500,53,376,429,0.12354312
G3600450060600,36,45,60600,51,675,726,0.070247933
G3600450060700,36,45,60700,70,404,474,0.14767933
G3600450060803,36,45,60803,107,507,614,0.1742671
G3600450060804,36,45,60804,99,761,860,0.11511628
G3600450060900,36,45,60900,120,493,613,0.19575857
G3600450061000,36,45,61000,19,299,318,0.059748426
G3600450061100,36,45,61100,16,521,537,0.029795159
G3600450061200,36,45,61200,203,194,397,0.51133502
G3600450061300,36,45,61300,123,223,346,0.35549134
G3600450061400,36,45,61400,127,159,286,0.44405594
G3600450061500,36,45,61500,29,285,314,0.092356689
G3600450061600,36,45,61600,40,370,410,0.097560972
G3600450061700,36,45,61700,28,199,227,0.12334802
G3600450061800,36,45,61800,230,654,884,0.26018101
G3600450061900,36,45,61900,90,211,301,0.29900333
G3600450062100,36,45,62100,71,208,279,0.25448027
G3600450062200,36,45,62200,30,233,263,0.11406844
G3600450062400,36,45,62400,27,423,450,0.059999999
G3600450062500,36,45,62500,64,234,298,0.2147651
G3600450980000,36,45,980000,8,0,8,1
G3600450990001,36,45,990001,0,0,0,
G3600470000100,36,47,100,0,136,136,0
G3600470000200,36,47,200,78,99,177,0.44067797
G3600470000301,36,47,301,0,190,190,0
G3600470000501,36,47,501,41,152,193,0.21243523
G3600470000502,36,47,502,0,91,91,0
G3600470000700,36,47,700,0,256,256,0
G3600470000900,36,47,900,0,123,123,0
G3600470001100,36,47,1100,0,11,11,0
G3600470001300,36,47,1300,6,113,119,0.050420169
G3600470001500,36,47,1500,180,250,430,0.41860464
G3600470001800,36,47,1800,0,0,0,
G3600470002000,36,47,2000,81,143,224,0.36160713
G3600470002100,36,47,2100,8,208,216,0.037037037
G3600470002200,36,47,2200,134,188,322,0.41614908
G3600470002300,36,47,2300,280,163,443,0.63205415
G3600470002901,36,47,2901,388,131,519,0.7475915
G3600470003000,36,47,3000,31,163,194,0.15979381
G3600470003100,36,47,3100,0,118,118,0
G3600470003300,36,47,3300,50,101,151,0.33112583
G3600470003400,36,47,3400,96,224,320,0.30000001
G3600470003500,36,47,3500,4,126,130,0.030769231
G3600470003600,36,47,3600,25,390,415,0.060240965
G3600470003700,36,47,3700,0,36,36,0
G3600470003800,36,47,3800,16,75,91,0.17582418
G3600470003900,36,47,3900,6,130,136,0.044117648
G3600470004100,36,47,4100,0,298,298,0
G3600470004300,36,47,4300,0,178,178,0
G3600470004400,36,47,4400,24,185,209,0.11483254
G3600470004500,36,47,4500,0,211,211,0
G3600470004600,36,47,4600,0,145,145,0
G3600470004700,36,47,4700,21,166,187,0.11229946
G3600470004900,36,47,4900,0,86,86,0
G3600470005000,36,47,5000,0,189,189,0
G3600470005100,36,47,5100,20,172,192,0.10416666
G3600470005201,36,47,5201,0,84,84,0
G3600470005202,36,47,5202,0,130,130,0
G3600470005300,36,47,5300,27,193,220,0.12272727
G3600470005400,36,47,5400,39,173,212,0.18396227
G3600470005601,36,47,5601,50,83,133,0.37593985
G3600470005602,36,47,5602,10,133,143,0.069930069
G3600470005800,36,47,5800,241,170,411,0.5863747
G3600470005900,36,47,5900,24,33,57,0.42105263
G3600470006000,36,47,6000,106,156,262,0.40458015
G3600470006200,36,47,6200,120,225,345,0.34782609
G3600470006300,36,47,6300,20,125,145,0.13793103
G3600470006400,36,47,6400,36,257,293,0.12286689
G3600470006500,36,47,6500,0,328,328,0
G3600470006600,36,47,6600,35,298,333,0.1051051
G3600470006700,36,47,6700,0,246,246,0
G3600470006800,36,47,6800,223,343,566,0.39399293
G3600470006900,36,47,6900,0,199,199,0
G3600470007000,36,47,7000,48,224,272,0.17647059
G3600470007100,36,47,7100,188,360,548,0.34306568
G3600470007200,36,47,7200,179,122,301,0.59468436
G3600470007400,36,47,7400,310,444,754,0.41114059
G3600470007500,36,47,7500,0,340,340,0
G3600470007600,36,47,7600,394,253,647,0.60896444
G3600470007700,36,47,7700,4,287,291,0.013745705
G3600470007800,36,47,7800,143,329,472,0.30296609
G3600470008000,36,47,8000,58,391,449,0.12917595
G3600470008200,36,47,8200,247,271,518,0.47683397
G3600470008400,36,47,8400,128,314,442,0.28959277
G3600470008500,36,47,8500,681,370,1051,0.64795434
G3600470008600,36,47,8600,0,0,0,
G3600470008800,36,47,8800,9,257,266,0.033834588
G3600470009000,36,47,9000,116,220,336,0.34523809
G3600470009200,36,47,9200,357,365,722,0.49445984
G3600470009400,36,47,9400,275,275,550,0.5
G3600470009600,36,47,9600,279,358,637,0.43799058
G3600470009800,36,47,9800,599,433,1032,0.58042634
G3600470010000,36,47,10000,489,270,759,0.64426875
G3600470010100,36,47,10100,173,338,511,0.33855185
G3600470010200,36,47,10200,196,308,504,0.3888889
G3600470010400,36,47,10400,264,393,657,0.40182647
G3600470010600,36,47,10600,222,262,484,0.45867768
G3600470010800,36,47,10800,297,242,539,0.55102038
G3600470011000,36,47,11000,69,201,270,0.25555557
G3600470011200,36,47,11200,335,547,882,0.37981859
G3600470011400,36,47,11400,170,215,385,0.44155845
G3600470011600,36,47,11600,148,207,355,0.41690141
G3600470011700,36,47,11700,36,153,189,0.19047619
G3600470011800,36,47,11800,98,155,253,0.38735178
G3600470011900,36,47,11900,5,42,47,0.10638298
G3600470012000,36,47,12000,61,84,145,0.42068964
G3600470012100,36,47,12100,17,95,112,0.15178572
G3600470012200,36,47,12200,267,288,555,0.48108107
G3600470012600,36,47,12600,115,183,298,0.38590604
G3600470012700,36,47,12700,145,136,281,0.51601422
G3600470012801,36,47,12801,65,137,202,0.32178217
G3600470012901,36,47,12901,26,90,116,0.22413793
G3600470012902,36,47,12902,0,132,132,0
G3600470013000,36,47,13000,172,379,551,0.31215972
G3600470013100,36,47,13100,68,259,327,0.20795107
G3600470013200,36,47,13200,86,231,317,0.27129337
G3600470013300,36,47,13300,16,423,439,0.036446471
G3600470013400,36,47,13400,0,342,342,0
G3600470013500,36,47,13500,7,405,412,0.016990291
G3600470013600,36,47,13600,18,344,362,0.049723756
G3600470013700,36,47,13700,45,198,243,0.18518518
G3600470013800,36,47,13800,71,130,201,0.35323384
G3600470013900,36,47,13900,16,231,247,0.06477733
G3600470014000,36,47,14000,15,151,166,0.090361446
G3600470014100,36,47,14100,42,325,367,0.11444142
G3600470014200,36,47,14200,42,234,276,0.15217391
G3600470014300,36,47,14300,44,150,194,0.22680412
G3600470014500,36,47,14500,23,223,246,0.093495935
G3600470014700,36,47,14700,26,113,139,0.18705036
G3600470014800,36,47,14800,50,112,162,0.30864197
G3600470014900,36,47,14900,24,436,460,0.052173913
G3600470015000,36,47,15000,22,125,147,0.14965986
G3600470015100,36,47,15100,8,378,386,0.020725388
G3600470015200,36,47,15200,0,189,189,0
G3600470015300,36,47,15300,0,197,197,0
G3600470015400,36,47,15400,0,0,0,
G3600470015500,36,47,15500,8,389,397,0.020151133
G3600470015700,36,47,15700,0,331,331,0
G3600470015900,36,47,15900,18,297,315,0.057142857
G3600470016000,36,47,16000,88,261,349,0.25214899
G3600470016100,36,47,16100,31,133,164,0.18902439
G3600470016200,36,47,16200,52,224,276,0.1884058
G3600470016300,36,47,16300,0,199,199,0
G3600470016400,36,47,16400,0,69,69,0
G3600470016500,36,47,16500,0,532,532,0
G3600470016600,36,47,16600,5,174,179,0.027932961
G3600470016700,36,47,16700,0,548,548,0
G3600470016800,36,47,16800,37,136,173,0.21387284
G3600470016900,36,47,16900,99,205,304,0.3256579
G3600470017000,36,47,17000,130,286,416,0.3125
G3600470017100,36,47,17100,40,361,401,0.099750623
G3600470017200,36,47,17200,35,278,313,0.11182109
G3600470017400,36,47,17400,4,180,184,0.021739131
G3600470017500,36,47,17500,0,0,0,
G3600470017600,36,47,17600,15,147,162,0.09259259
G3600470017700,36,47,17700,0,0,0,
G3600470017800,36,47,17800,83,263,346,0.23988439
G3600470017900,36,47,17900,105,180,285,0.36842105
G3600470018000,36,47,18000,150,319,469,0.31982943
G3600470018100,36,47,18100,26,220,246,0.10569106
G3600470018200,36,47,18200,153,200,353,0.43342775
G3600470018300,36,47,18300,7,113,120,0.058333334
G3600470018400,36,47,18400,37,205,242,0.15289256
G3600470018501,36,47,18501,391,283,674,0.58011872
G3600470018600,36,47,18600,20,198,218,0.091743119
G3600470018700,36,47,18700,6,67,73,0.08219178
G3600470018800,36,47,18800,62,321,383,0.1618799
G3600470019000,36,47,19000,128,369,497,0.25754526
G3600470019100,36,47,19100,53,197,250,0.212
G3600470019200,36,47,19200,136,230,366,0.37158471
G3600470019300,36,47,19300,56,333,389,0.14395887
G3600470019400,36,47,19400,78,305,383,0.20365535
G3600470019500,36,47,19500,22,254,276,0.079710148
G3600470019600,36,47,19600,120,497,617,0.19448946
G3600470019700,36,47,19700,0,181,181,0
G3600470019800,36,47,19800,110,138,248,0.44354838
G3600470019900,36,47,19900,20,132,152,0.13157895
G3600470020000,36,47,20000,29,236,265,0.10943396
G3600470020100,36,47,20100,8,281,289,0.027681662
G3600470020200,36,47,20200,5,210,215,0.023255814
G3600470020300,36,47,20300,21,81,102,0.20588236
G3600470020400,36,47,20400,30,172,202,0.14851485
G3600470020500,36,47,20500,0,154,154,0
G3600470020600,36,47,20600,15,200,215,0.069767445
G3600470020700,36,47,20700,13,312,325,0.039999999
G3600470020800,36,47,20800,91,208,299,0.30434781
G3600470021000,36,47,21000,125,374,499,0.25050101
G3600470021100,36,47,21100,33,92,125,0.264
G3600470021200,36,47,21200,260,347,607,0.42833608
G3600470021300,36,47,21300,85,286,371,0.22911051
G3600470021400,36,47,21400,32,181,213,0.15023474
G3600470021500,36,47,21500,55,240,295,0.18644068
G3600470021600,36,47,21600,134,262,396,0.33838382
G3600470021700,36,47,21700,49,264,313,0.15654951
G3600470021800,36,47,21800,230,267,497,0.46277666
G3600470021900,36,47,21900,30,213,243,0.12345679
G3600470022000,36,47,22000,66,171,237,0.27848101
G3600470022100,36,47,22100,30,267,297,0.1010101
G3600470022200,36,47,22200,110,230,340,0.32352942
G3600470022400,36,47,22400,238,360,598,0.3979933
G3600470022600,36,47,22600,44,197,241,0.18257262
G3600470022700,36,47,22700,18,241,259,0.06949807
G3600470022800,36,47,22800,234,238,472,0.49576271
G3600470022900,36,47,22900,77,228,305,0.25245902
G3600470023000,36,47,23000,193,262,455,0.42417583
G3600470023100,36,47,23100,28,163,191,0.14659686
G3600470023200,36,47,23200,218,288,506,0.43083003
G3600470023300,36,47,23300,136,302,438,0.31050229
G3600470023400,36,47,23400,106,224,330,0.32121211
G3600470023500,36,47,23500,91,171,262,0.34732825
G3600470023600,36,47,23600,126,234,360,0.34999999
G3600470023800,36,47,23800,100,210,310,0.32258064
G3600470024000,36,47,24000,181,209,390,0.46410257
G3600470024100,36,47,24100,31,100,131,0.23664123
G3600470024200,36,47,24200,68,171,239,0.28451884
G3600470024300,36,47,24300,38,253,291,0.1305842
G3600470024400,36,47,24400,97,211,308,0.31493506
G3600470024500,36,47,24500,74,326,400,0.185
G3600470024600,36,47,24600,114,240,354,0.32203391
G3600470024700,36,47,24700,12,114,126,0.095238097
G3600470024800,36,47,24800,118,231,349,0.3381089
G3600470024900,36,47,24900,66,251,317,0.2082019
G3600470025000,36,47,25000,51,71,122,0.4180328
G3600470025100,36,47,25100,105,182,287,0.36585367
G3600470025200,36,47,25200,179,487,666,0.26876876
G3600470025300,36,47,25300,41,135,176,0.23295455
G3600470025400,36,47,25400,76,313,389,0.19537275
G3600470025500,36,47,25500,403,288,691,0.58321273
G3600470025600,36,47,25600,142,250,392,0.3622449
G3600470025700,36,47,25700,113,78,191,0.59162301
G3600470025800,36,47,25800,98,162,260,0.37692308
G3600470025901,36,47,25901,68,96,164,0.41463414
G3600470025902,36,47,25902,300,123,423,0.70921987
G3600470026000,36,47,26000,64,224,288,0.22222222
G3600470026100,36,47,26100,126,348,474,0.2658228
G3600470026200,36,47,26200,92,167,259,0.35521236
G3600470026300,36,47,26300,28,145,173,0.16184971
G3600470026400,36,47,26400,62,410,472,0.13135593
G3600470026500,36,47,26500,95,201,296,0.32094595
G3600470026600,36,47,26600,72,291,363,0.19834711
G3600470026700,36,47,26700,124,119,243,0.51028806
G3600470026800,36,47,26800,80,232,312,0.25641027
G3600470026900,36,47,26900,0,185,185,0
G3600470027000,36,47,27000,7,192,199,0.035175879
G3600470027100,36,47,27100,103,137,240,0.42916667
G3600470027200,36,47,27200,160,353,513,0.31189084
G3600470027300,36,47,27300,78,189,267,0.29213482
G3600470027400,36,47,27400,7,256,263,0.02661597
G3600470027500,36,47,27500,128,305,433,0.29561201
G3600470027600,36,47,27600,208,337,545,0.38165137
G3600470027700,36,47,27700,193,261,454,0.42511013
G3600470027800,36,47,27800,37,220,257,0.14396887
G3600470027900,36,47,27900,60,200,260,0.23076923
G3600470028000,36,47,28000,19,132,151,0.12582782
G3600470028100,36,47,28100,310,186,496,0.625
G3600470028200,36,47,28200,113,274,387,0.29198965
G3600470028300,36,47,28300,224,229,453,0.49448124
G3600470028400,36,47,28400,176,221,397,0.44332492
G3600470028501,36,47,28501,0,13,13,0
G3600470028502,36,47,28502,153,27,180,0.85000002
G3600470028600,36,47,28600,98,263,361,0.27146813
G3600470028700,36,47,28700,76,173,249,0.30522087
G3600470028800,36,47,28800,100,158,258,0.38759691
G3600470028900,36,47,28900,110,246,356,0.30898875
G3600470029000,36,47,29000,86,140,226,0.38053098
G3600470029100,36,47,29100,47,267,314,0.14968152
G3600470029200,36,47,29200,55,153,208,0.26442307
G3600470029300,36,47,29300,110,286,396,0.27777779
G3600470029400,36,47,29400,14,166,180,0.077777781
G3600470029500,36,47,29500,109,209,318,0.3427673
G3600470029600,36,47,29600,230,407,637,0.3610675
G3600470029700,36,47,29700,99,210,309,0.32038835
G3600470029800,36,47,29800,56,416,472,0.11864407
G3600470029900,36,47,29900,152,134,286,0.53146851
G3600470030000,36,47,30000,109,330,439,0.24829157
G3600470030100,36,47,30100,115,211,326,0.35276073
G3600470030200,36,47,30200,75,399,474,0.15822785
G3600470030300,36,47,30300,462,269,731,0.63201094
G3600470030400,36,47,30400,128,244,372,0.34408602
G3600470030500,36,47,30500,69,221,290,0.23793103
G3600470030600,36,47,30600,53,99,152,0.34868422
G3600470030700,36,47,30700,193,517,710,0.27183098
G3600470030800,36,47,30800,81,111,192,0.421875
G3600470030900,36,47,30900,157,113,270,0.58148146
G3600470031100,36,47,31100,87,227,314,0.27707008
G3600470031300,36,47,31300,114,268,382,0.29842931
G3600470031400,36,47,31400,113,263,376,0.30053192
G3600470031500,36,47,31500,69,111,180,0.38333333
G3600470031701,36,47,31701,6,226,232,0.02586207
G3600470031702,36,47,31702,76,153,229,0.33187774
G3600470031900,36,47,31900,118,237,355,0.33239436
G3600470032100,36,47,32100,190,526,716,0.26536313
G3600470032300,36,47,32300,52,318,370,0.14054054
G3600470032500,36,47,32500,158,343,501,0.31536925
G3600470032600,36,47,32600,309,503,812,0.38054186
G3600470032700,36,47,32700,107,139,246,0.43495935
G3600470032800,36,47,32800,63,161,224,0.28125
G3600470032900,36,47,32900,15,404,419,0.035799522
G3600470033000,36,47,33000,350,383,733,0.47748977
G3600470033100,36,47,33100,53,336,389,0.13624679
G3600470033300,36,47,33300,81,442,523,0.15487571
G3600470033500,36,47,33500,35,220,255,0.13725491
G3600470033600,36,47,33600,57,386,443,0.12866817
G3600470033700,36,47,33700,103,365,468,0.22008547
G3600470033900,36,47,33900,145,202,347,0.41786742
G3600470034000,36,47,34000,43,70,113,0.38053098
G3600470034100,36,47,34100,54,186,240,0.22499999
G3600470034200,36,47,34200,189,294,483,0.39130434
G3600470034300,36,47,34300,317,386,703,0.45092461
G3600470034500,36,47,34500,155,149,304,0.50986844
G3600470034700,36,47,34700,167,168,335,0.49850747
G3600470034800,36,47,34800,77,85,162,0.47530866
G3600470034900,36,47,34900,254,403,657,0.38660577
G3600470035000,36,47,35000,21,97,118,0.1779661
G3600470035100,36,47,35100,201,292,493,0.4077079
G3600470035200,36,47,35200,25,0,25,1
G3600470035300,36,47,35300,135,324,459,0.29411766
G3600470035400,36,47,35400,0,291,291,0
G3600470035500,36,47,35500,91,479,570,0.15964912
G3600470035601,36,47,35601,0,131,131,0
G3600470035602,36,47,35602,0,183,183,0
G3600470035700,36,47,35700,231,141,372,0.62096775
G3600470035900,36,47,35900,340,307,647,0.52550232
G3600470036001,36,47,36001,40,46,86,0.46511629
G3600470036002,36,47,36002,14,261,275,0.050909091
G3600470036100,36,47,36100,58,194,252,0.23015873
G3600470036200,36,47,36200,234,179,413,0.56658596
G3600470036300,36,47,36300,128,336,464,0.27586207
G3600470036400,36,47,36400,70,110,180,0.3888889
G3600470036501,36,47,36501,79,218,297,0.26599327
G3600470036502,36,47,36502,42,50,92,0.45652175
G3600470036600,36,47,36600,162,267,429,0.37762237
G3600470036700,36,47,36700,82,135,217,0.37788019
G3600470036900,36,47,36900,333,425,758,0.43931398
G3600470037000,36,47,37000,62,441,503,0.12326044
G3600470037100,36,47,37100,181,462,643,0.28149301
G3600470037300,36,47,37300,251,320,571,0.4395797
G3600470037401,36,47,37401,19,322,341,0.055718474
G3600470037402,36,47,37402,28,398,426,0.065727696
G3600470037500,36,47,37500,105,223,328,0.32012194
G3600470037700,36,47,37700,125,194,319,0.39184952
G3600470037900,36,47,37900,174,242,416,0.41826922
G3600470038100,36,47,38100,258,387,645,0.40000001
G3600470038200,36,47,38200,472,327,799,0.59073842
G3600470038300,36,47,38300,53,402,455,0.11648352
G3600470038500,36,47,38500,137,280,417,0.32853717
G3600470038600,36,47,38600,166,186,352,0.47159091
G3600470038700,36,47,38700,173,227,400,0.4325
G3600470038800,36,47,38800,93,359,452,0.20575221
G3600470038900,36,47,38900,69,161,230,0.30000001
G3600470039000,36,47,39000,36,181,217,0.16589862
G3600470039100,36,47,39100,164,216,380,0.43157893
G3600470039200,36,47,39200,55,250,305,0.18032786
G3600470039300,36,47,39300,32,226,258,0.12403101
G3600470039400,36,47,39400,18,261,279,0.064516127
G3600470039500,36,47,39500,107,183,290,0.36896551
G3600470039600,36,47,39600,68,250,318,0.21383648
G3600470039700,36,47,39700,155,195,350,0.44285715
G3600470039800,36,47,39800,58,151,209,0.27751195
G3600470039900,36,47,39900,123,168,291,0.42268041
G3600470040000,36,47,40000,145,218,363,0.39944905
G3600470040100,36,47,40100,77,232,309,0.24919094
G3600470040200,36,47,40200,58,132,190,0.30526316
G3600470040300,36,47,40300,209,117,326,0.64110428
G3600470040400,36,47,40400,55,183,238,0.23109244
G3600470040500,36,47,40500,64,106,170,0.3764706
G3600470040600,36,47,40600,38,359,397,0.095717885
G3600470040700,36,47,40700,0,0,0,
G3600470040800,36,47,40800,113,188,301,0.3754153
G3600470040900,36,47,40900,203,300,503,0.40357852
G3600470041000,36,47,41000,40,121,161,0.24844721
G3600470041100,36,47,41100,135,216,351,0.38461539
G3600470041200,36,47,41200,25,303,328,0.076219514
G3600470041300,36,47,41300,85,418,503,0.16898608
G3600470041401,36,47,41401,0,115,115,0
G3600470041402,36,47,41402,0,106,106,0
G3600470041500,36,47,41500,98,471,569,0.17223199
G3600470041600,36,47,41600,127,204,331,0.3836858
G3600470041700,36,47,41700,171,274,445,0.38426965
G3600470041800,36,47,41800,29,193,222,0.13063063
G3600470041900,36,47,41900,279,349,628,0.44426751
G3600470042000,36,47,42000,67,145,212,0.31603774
G3600470042100,36,47,42100,108,220,328,0.32926831
G3600470042200,36,47,42200,0,308,308,0
G3600470042300,36,47,42300,153,343,496,0.30846775
G3600470042400,36,47,42400,16,215,231,0.069264069
G3600470042500,36,47,42500,84,229,313,0.2683706
G3600470042600,36,47,42600,199,250,449,0.44320711
G3600470042700,36,47,42700,374,153,527,0.7096774
G3600470042800,36,47,42800,16,245,261,0.061302681
G3600470042900,36,47,42900,181,361,542,0.33394834
G3600470043000,36,47,43000,44,195,239,0.18410042
G3600470043100,36,47,43100,187,245,432,0.43287036
G3600470043200,36,47,43200,163,322,485,0.33608249
G3600470043300,36,47,43300,228,406,634,0.35962147
G3600470043400,36,47,43400,60,277,337,0.17804155
G3600470043500,36,47,43500,192,393,585,0.32820514
G3600470043600,36,47,43600,62,301,363,0.1707989
G3600470043700,36,47,43700,221,333,554,0.39891696
G3600470043800,36,47,43800,28,158,186,0.15053764
G3600470043900,36,47,43900,125,322,447,0.27964205
G3600470044000,36,47,44000,107,213,320,0.33437499
G3600470044100,36,47,44100,222,419,641,0.34633386
G3600470044200,36,47,44200,25,260,285,0.087719299
G3600470044300,36,47,44300,164,423,587,0.2793867
G3600470044400,36,47,44400,21,253,274,0.076642334
G3600470044500,36,47,44500,194,363,557,0.34829444
G3600470044600,36,47,44600,43,115,158,0.27215189
G3600470044700,36,47,44700,58,171,229,0.2532751
G3600470044800,36,47,44800,27,93,120,0.22499999
G3600470044900,36,47,44900,157,199,356,0.44101125
G3600470045000,36,47,45000,22,26,48,0.45833334
G3600470045200,36,47,45200,84,200,284,0.29577464
G3600470045300,36,47,45300,69,75,144,0.47916666
G3600470045400,36,47,45400,51,140,191,0.2670157
G3600470045600,36,47,45600,80,181,261,0.3065134
G3600470045800,36,47,45800,16,174,190,0.08421053
G3600470046000,36,47,46000,82,229,311,0.26366559
G3600470046201,36,47,46201,40,211,251,0.15936255
G3600470046202,36,47,46202,36,133,169,0.21301775
G3600470046400,36,47,46400,98,210,308,0.31818181
G3600470046800,36,47,46800,24,142,166,0.14457831
G3600470047000,36,47,47000,102,147,249,0.40963855
G3600470047200,36,47,47200,89,206,295,0.30169493
G3600470047400,36,47,47400,68,230,298,0.22818792
G3600470047600,36,47,47600,17,210,227,0.074889868
G3600470047700,36,47,47700,34,68,102,0.33333334
G3600470047800,36,47,47800,126,250,376,0.33510637
G3600470048000,36,47,48000,32,243,275,0.11636364
G3600470048100,36,47,48100,0,198,198,0
G3600470048200,36,47,48200,71,282,353,0.20113315
G3600470048400,36,47,48400,167,380,547,0.30530164
G3600470048500,36,47,48500,0,83,83,0
G3600470048600,36,47,48600,149,199,348,0.42816091
G3600470048800,36,47,48800,156,307,463,0.33693305
G3600470048900,36,47,48900,189,152,341,0.55425221
G3600470049000,36,47,49000,110,293,403,0.27295285
G3600470049100,36,47,49100,148,397,545,0.27155963
G3600470049200,36,47,49200,51,208,259,0.1969112
G3600470049300,36,47,49300,145,494,639,0.22691706
G3600470049400,36,47,49400,119,349,468,0.2542735
G3600470049500,36,47,49500,17,121,138,0.12318841
G3600470049600,36,47,49600,75,427,502,0.14940239
G3600470049700,36,47,49700,12,30,42,0.2857143
G3600470049800,36,47,49800,109,339,448,0.24330357
G3600470049900,36,47,49900,0,70,70,0
G3600470050000,36,47,50000,50,330,380,0.13157895
G3600470050100,36,47,50100,62,129,191,0.32460734
G3600470050202,36,47,50202,0,159,159,0
G3600470050300,36,47,50300,0,75,75,0
G3600470050400,36,47,50400,147,289,436,0.33715597
G3600470050500,36,47,50500,200,146,346,0.5780347
G3600470050600,36,47,50600,199,432,631,0.31537244
G3600470050700,36,47,50700,58,151,209,0.27751195
G3600470050801,36,47,50801,121,260,381,0.31758529
G3600470050803,36,47,50803,25,102,127,0.19685039
G3600470050804,36,47,50804,146,286,432,0.33796296
G3600470050900,36,47,50900,139,211,350,0.39714286
G3600470051001,36,47,51001,32,324,356,0.089887641
G3600470051002,36,47,51002,141,434,575,0.2452174
G3600470051100,36,47,51100,216,124,340,0.63529414
G3600470051200,36,47,51200,184,352,536,0.34328359
G3600470051300,36,47,51300,97,153,250,0.38800001
G3600470051400,36,47,51400,138,664,802,0.17206983
G3600470051500,36,47,51500,0,66,66,0
G3600470051601,36,47,51601,88,423,511,0.17221135
G3600470051602,36,47,51602,64,316,380,0.16842106
G3600470051700,36,47,51700,0,9,9,0
G3600470051800,36,47,51800,37,268,305,0.12131148
G3600470051900,36,47,51900,18,115,133,0.13533835
G3600470052000,36,47,52000,86,362,448,0.19196428
G3600470052300,36,47,52300,46,174,220,0.2090909
G3600470052500,36,47,52500,125,156,281,0.44483986
G3600470052600,36,47,52600,123,413,536,0.22947761
G3600470052700,36,47,52700,351,241,592,0.5929054
G3600470052800,36,47,52800,44,166,210,0.20952381
G3600470052900,36,47,52900,122,134,256,0.4765625
G3600470053000,36,47,53000,51,240,291,0.17525773
G3600470053100,36,47,53100,162,504,666,0.24324325
G3600470053200,36,47,53200,44,96,140,0.31428573
G3600470053300,36,47,53300,223,244,467,0.47751606
G3600470053400,36,47,53400,193,171,364,0.53021979
G3600470053500,36,47,53500,87,200,287,0.3031359
G3600470053700,36,47,53700,260,201,461,0.56399131
G3600470053800,36,47,53800,71,167,238,0.29831934
G3600470053900,36,47,53900,89,127,216,0.41203704
G3600470054200,36,47,54200,132,330,462,0.2857143
G3600470054300,36,47,54300,12,42,54,0.22222222
G3600470054400,36,47,54400,48,229,277,0.1732852
G3600470054500,36,47,54500,355,364,719,0.4937413
G3600470054600,36,47,54600,114,359,473,0.24101479
G3600470054700,36,47,54700,157,245,402,0.39054728
G3600470054800,36,47,54800,32,174,206,0.15533981
G3600470054900,36,47,54900,0,127,127,0
G3600470055000,36,47,55000,55,232,287,0.19163764
G3600470055100,36,47,55100,55,431,486,0.11316872
G3600470055200,36,47,55200,110,132,242,0.45454547
G3600470055300,36,47,55300,2,96,98,0.020408163
G3600470055400,36,47,55400,155,253,408,0.37990198
G3600470055500,36,47,55500,33,269,302,0.10927153
G3600470055600,36,47,55600,52,274,326,0.1595092
G3600470055700,36,47,55700,12,58,70,0.17142858
G3600470055800,36,47,55800,104,200,304,0.34210527
G3600470056000,36,47,56000,98,287,385,0.25454545
G3600470056100,36,47,56100,2,92,94,0.021276595
G3600470056200,36,47,56200,26,141,167,0.15568863
G3600470056300,36,47,56300,88,150,238,0.36974791
G3600470056400,36,47,56400,0,232,232,0
G3600470056500,36,47,56500,0,145,145,0
G3600470056600,36,47,56600,20,210,230,0.086956523
G3600470056800,36,47,56800,16,92,108,0.14814815
G3600470056900,36,47,56900,20,64,84,0.23809524
G3600470057000,36,47,57000,24,219,243,0.098765433
G3600470057100,36,47,57100,53,111,164,0.32317072
G3600470057200,36,47,57200,301,250,551,0.54627949
G3600470057300,36,47,57300,21,84,105,0.2
G3600470057400,36,47,57400,13,220,233,0.055793993
G3600470057500,36,47,57500,21,193,214,0.098130845
G3600470057600,36,47,57600,70,226,296,0.23648648
G3600470057800,36,47,57800,143,235,378,0.37830687
G3600470057900,36,47,57900,27,49,76,0.35526314
G3600470058000,36,47,58000,90,347,437,0.20594966
G3600470058200,36,47,58200,159,301,460,0.34565216
G3600470058400,36,47,58400,9,211,220,0.040909089
G3600470058600,36,47,58600,60,250,310,0.19354838
G3600470058800,36,47,58800,9,203,212,0.042452831
G3600470058900,36,47,58900,0,88,88,0
G3600470059000,36,47,59000,15,117,132,0.11363637
G3600470059100,36,47,59100,16,150,166,0.096385539
G3600470059200,36,47,59200,18,332,350,0.051428571
G3600470059300,36,47,59300,15,90,105,0.14285715
G3600470059401,36,47,59401,153,594,747,0.20481928
G3600470059402,36,47,59402,0,332,332,0
G3600470059600,36,47,59600,0,171,171,0
G3600470059800,36,47,59800,273,272,545,0.50091743
G3600470060000,36,47,60000,197,391,588,0.33503401
G3600470060600,36,47,60600,41,129,170,0.24117647
G3600470060800,36,47,60800,7,243,250,0.028000001
G3600470061002,36,47,61002,0,442,442,0
G3600470061003,36,47,61003,65,133,198,0.32828283
G3600470061004,36,47,61004,102,299,401,0.2543641
G3600470061200,36,47,61200,0,58,58,0
G3600470061600,36,47,61600,0,118,118,0
G3600470062000,36,47,62000,4,213,217,0.01843318
G3600470062200,36,47,62200,10,238,248,0.040322579
G3600470062600,36,47,62600,93,197,290,0.32068965
G3600470062800,36,47,62800,59,473,532,0.11090226
G3600470063200,36,47,63200,24,167,191,0.12565444
G3600470063600,36,47,63600,0,141,141,0
G3600470063800,36,47,63800,0,108,108,0
G3600470064000,36,47,64000,0,158,158,0
G3600470064200,36,47,64200,38,172,210,0.18095239
G3600470064400,36,47,64400,44,198,242,0.18181819
G3600470064600,36,47,64600,0,229,229,0
G3600470064800,36,47,64800,39,167,206,0.18932039
G3600470065000,36,47,65000,28,137,165,0.16969697
G3600470065200,36,47,65200,18,67,85,0.21176471
G3600470065400,36,47,65400,29,188,217,0.13364056
G3600470065600,36,47,65600,14,151,165,0.084848486
G3600470065800,36,47,65800,28,184,212,0.13207547
G3600470066000,36,47,66000,0,246,246,0
G3600470066200,36,47,66200,0,160,160,0
G3600470066600,36,47,66600,0,0,0,
G3600470067000,36,47,67000,37,281,318,0.1163522
G3600470067200,36,47,67200,52,155,207,0.25120774
G3600470067400,36,47,67400,6,154,160,0.037500001
G3600470067600,36,47,67600,6,154,160,0.037500001
G3600470067800,36,47,67800,0,201,201,0
G3600470068000,36,47,68000,90,185,275,0.32727271
G3600470068200,36,47,68200,0,240,240,0
G3600470068600,36,47,68600,6,85,91,0.065934069
G3600470068800,36,47,68800,0,198,198,0
G3600470069000,36,47,69000,36,207,243,0.14814815
G3600470069200,36,47,69200,9,324,333,0.027027028
G3600470069601,36,47,69601,119,441,560,0.21250001
G3600470069602,36,47,69602,180,605,785,0.22929937
G3600470069800,36,47,69800,20,138,158,0.12658228
G3600470070000,36,47,70000,18,128,146,0.12328767
G3600470070201,36,47,70201,60,587,647,0.0927357
G3600470070202,36,47,70202,0,0,0,
G3600470070203,36,47,70203,0,0,0,
G3600470070600,36,47,70600,0,268,268,0
G3600470072000,36,47,72000,20,262,282,0.070921987
G3600470072200,36,47,72200,59,255,314,0.18789808
G3600470072400,36,47,72400,9,162,171,0.052631579
G3600470072600,36,47,72600,19,154,173,0.10982659
G3600470072800,36,47,72800,7,280,287,0.024390243
G3600470073000,36,47,73000,14,188,202,0.069306932
G3600470073200,36,47,73200,33,247,280,0.11785714
G3600470073400,36,47,73400,20,203,223,0.089686096
G3600470073600,36,47,73600,53,321,374,0.14171124
G3600470073800,36,47,73800,112,232,344,0.3255814
G3600470074000,36,47,74000,118,400,518,0.22779922
G3600470074200,36,47,74200,74,319,393,0.18829517
G3600470074400,36,47,74400,39,244,283,0.13780919
G3600470074600,36,47,74600,51,241,292,0.17465754
G3600470074800,36,47,74800,63,149,212,0.2971698
G3600470075000,36,47,75000,78,218,296,0.26351351
G3600470075200,36,47,75200,0,99,99,0
G3600470075400,36,47,75400,102,93,195,0.52307695
G3600470075600,36,47,75600,17,166,183,0.092896178
G3600470075800,36,47,75800,11,182,193,0.056994818
G3600470076000,36,47,76000,74,227,301,0.24584718
G3600470076200,36,47,76200,159,244,403,0.39454094
G3600470076400,36,47,76400,34,334,368,0.092391305
G3600470076600,36,47,76600,30,235,265,0.11320755
G3600470076800,36,47,76800,45,233,278,0.16187051
G3600470077000,36,47,77000,91,321,412,0.22087379
G3600470077200,36,47,77200,69,184,253,0.27272728
G3600470077400,36,47,77400,29,281,310,0.093548387
G3600470077600,36,47,77600,20,229,249,0.080321282
G3600470078000,36,47,78000,31,209,240,0.12916666
G3600470078200,36,47,78200,104,337,441,0.23582767
G3600470078400,36,47,78400,23,232,255,0.090196081
G3600470078600,36,47,78600,122,447,569,0.21441124
G3600470078800,36,47,78800,53,329,382,0.13874346
G3600470079000,36,47,79000,100,536,636,0.1572327
G3600470079200,36,47,79200,209,284,493,0.42393509
G3600470079400,36,47,79400,43,157,200,0.215
G3600470079601,36,47,79601,31,277,308,0.10064935
G3600470079602,36,47,79602,208,300,508,0.40944883
G3600470079801,36,47,79801,28,238,266,0.10526316
G3600470079802,36,47,79802,16,458,474,0.033755273
G3600470080000,36,47,80000,103,288,391,0.26342711
G3600470080200,36,47,80200,64,372,436,0.14678898
G3600470080400,36,47,80400,115,191,306,0.375817
G3600470080600,36,47,80600,72,265,337,0.21364985
G3600470080800,36,47,80800,0,4,4,0
G3600470081000,36,47,81000,63,155,218,0.28899083
G3600470081400,36,47,81400,48,170,218,0.22018349
G3600470081600,36,47,81600,126,218,344,0.36627907
G3600470081800,36,47,81800,147,309,456,0.32236841
G3600470082000,36,47,82000,141,389,530,0.26603773
G3600470082200,36,47,82200,238,672,910,0.26153848
G3600470082400,36,47,82400,143,387,530,0.26981133
G3600470082600,36,47,82600,109,301,410,0.26585367
G3600470082800,36,47,82800,70,376,446,0.15695067
G3600470083000,36,47,83000,67,658,725,0.092413791
G3600470083200,36,47,83200,14,211,225,0.062222224
G3600470083400,36,47,83400,20,107,127,0.15748031
G3600470083600,36,47,83600,36,171,207,0.17391305
G3600470083800,36,47,83800,14,203,217,0.064516127
G3600470084000,36,47,84000,6,159,165,0.036363635
G3600470084600,36,47,84600,27,88,115,0.23478261
G3600470084800,36,47,84800,9,102,111,0.081081077
G3600470085000,36,47,85000,32,117,149,0.2147651
G3600470085200,36,47,85200,0,0,0,
G3600470085400,36,47,85400,20,168,188,0.10638298
G3600470085600,36,47,85600,48,300,348,0.13793103
G3600470085800,36,47,85800,35,201,236,0.14830509
G3600470086000,36,47,86000,158,296,454,0.34801763
G3600470086200,36,47,86200,33,213,246,0.13414635
G3600470086400,36,47,86400,72,191,263,0.27376425
G3600470086600,36,47,86600,0,322,322,0
G3600470086800,36,47,86800,7,215,222,0.031531531
G3600470087000,36,47,87000,128,220,348,0.36781609
G3600470087200,36,47,87200,51,250,301,0.16943522
G3600470087401,36,47,87401,162,235,397,0.40806046
G3600470087600,36,47,87600,5,154,159,0.031446543
G3600470087800,36,47,87800,85,147,232,0.36637932
G3600470088000,36,47,88000,39,202,241,0.16182573
G3600470088200,36,47,88200,117,622,739,0.15832205
G3600470088400,36,47,88400,143,351,494,0.28947368
G3600470088600,36,47,88600,89,259,348,0.25574714
G3600470088800,36,47,88800,91,425,516,0.17635658
G3600470089000,36,47,89000,411,394,805,0.51055902
G3600470089200,36,47,89200,135,382,517,0.26112187
G3600470089400,36,47,89400,139,327,466,0.29828325
G3600470089600,36,47,89600,146,213,359,0.40668523
G3600470089800,36,47,89800,92,143,235,0.39148936
G3600470090000,36,47,90000,375,386,761,0.49277267
G3600470090200,36,47,90200,109,122,231,0.47186148
G3600470090600,36,47,90600,375,214,589,0.63667232
G3600470090800,36,47,90800,165,156,321,0.51401871
G3600470091000,36,47,91000,609,88,697,0.87374461
G3600470091200,36,47,91200,520,504,1024,0.5078125
G3600470091600,36,47,91600,195,396,591,0.32994923
G3600470091800,36,47,91800,194,110,304,0.6381579
G3600470092000,36,47,92000,200,162,362,0.55248618
G3600470092200,36,47,92200,8,219,227,0.035242289
G3600470092400,36,47,92400,120,313,433,0.27713627
G3600470092800,36,47,92800,23,216,239,0.096234307
G3600470093000,36,47,93000,16,194,210,0.076190479
G3600470093200,36,47,93200,6,100,106,0.056603774
G3600470093400,36,47,93400,33,151,184,0.17934783
G3600470093600,36,47,93600,22,139,161,0.13664596
G3600470093800,36,47,93800,133,172,305,0.43606558
G3600470094401,36,47,94401,54,277,331,0.163142
G3600470094402,36,47,94402,163,359,522,0.31226054
G3600470094600,36,47,94600,37,206,243,0.15226337
G3600470095000,36,47,95000,38,224,262,0.14503817
G3600470095400,36,47,95400,102,457,559,0.1824687
G3600470095600,36,47,95600,66,340,406,0.16256158
G3600470095800,36,47,95800,121,261,382,0.31675392
G3600470096000,36,47,96000,0,0,0,
G3600470096200,36,47,96200,29,162,191,0.15183246
G3600470096400,36,47,96400,70,185,255,0.27450982
G3600470096600,36,47,96600,30,191,221,0.13574661
G3600470096800,36,47,96800,12,154,166,0.072289154
G3600470097000,36,47,97000,43,188,231,0.18614718
G3600470097400,36,47,97400,12,331,343,0.034985423
G3600470098200,36,47,98200,366,325,691,0.52966714
G3600470098400,36,47,98400,49,130,179,0.273743
G3600470098600,36,47,98600,49,242,291,0.16838488
G3600470098800,36,47,98800,74,323,397,0.18639798
G3600470099000,36,47,99000,46,169,215,0.2139535
G3600470099200,36,47,99200,94,202,296,0.31756756
G3600470099400,36,47,99400,97,170,267,0.36329588
G3600470099600,36,47,99600,0,401,401,0
G3600470099800,36,47,99800,27,343,370,0.072972976
G3600470100400,36,47,100400,35,254,289,0.12110727
G3600470100600,36,47,100600,34,200,234,0.14529915
G3600470100800,36,47,100800,51,174,225,0.22666667
G3600470101000,36,47,101000,28,216,244,0.1147541
G3600470101200,36,47,101200,19,185,204,0.093137257
G3600470101400,36,47,101400,51,209,260,0.19615385
G3600470101600,36,47,101600,0,141,141,0
G3600470101800,36,47,101800,0,197,197,0
G3600470102000,36,47,102000,0,209,209,0
G3600470102200,36,47,102200,84,296,380,0.22105263
G3600470102400,36,47,102400,4,232,236,0.016949153
G3600470102600,36,47,102600,16,265,281,0.056939501
G3600470102800,36,47,102800,5,127,132,0.037878789
G3600470103400,36,47,103400,367,359,726,0.50550961
G3600470105801,36,47,105801,294,462,756,0.3888889
G3600470105804,36,47,105804,165,374,539,0.30612245
G3600470107000,36,47,107000,0,92,92,0
G3600470107800,36,47,107800,29,259,288,0.10069445
G3600470109800,36,47,109800,42,186,228,0.18421052
G3600470110400,36,47,110400,170,445,615,0.27642277
G3600470110600,36,47,110600,387,268,655,0.59083968
G3600470111000,36,47,111000,252,303,555,0.45405406
G3600470111600,36,47,111600,180,346,526,0.34220532
G3600470111800,36,47,111800,148,185,333,0.44444445
G3600470112000,36,47,112000,139,186,325,0.42769229
G3600470112200,36,47,112200,237,312,549,0.431694
G3600470112400,36,47,112400,121,188,309,0.39158577
G3600470112600,36,47,112600,206,326,532,0.38721806
G3600470112800,36,47,112800,242,234,476,0.50840336
G3600470113000,36,47,113000,274,217,491,0.55804479
G3600470113200,36,47,113200,43,183,226,0.19026549
G3600470113400,36,47,113400,218,154,372,0.58602148
G3600470114201,36,47,114201,26,126,152,0.17105263
G3600470114202,36,47,114202,19,255,274,0.069343068
G3600470114400,36,47,114400,142,208,350,0.40571427
G3600470114600,36,47,114600,209,243,452,0.46238938
G3600470115000,36,47,115000,75,263,338,0.22189349
G3600470115200,36,47,115200,159,190,349,0.45558739
G3600470115600,36,47,115600,385,252,637,0.60439563
G3600470115800,36,47,115800,88,176,264,0.33333334
G3600470116000,36,47,116000,76,214,290,0.26206896
G3600470116200,36,47,116200,57,101,158,0.3607595
G3600470116400,36,47,116400,80,218,298,0.26845637
G3600470116600,36,47,116600,70,297,367,0.1907357
G3600470116800,36,47,116800,125,96,221,0.56561089
G3600470117000,36,47,117000,54,127,181,0.29834256
G3600470117201,36,47,117201,90,181,271,0.33210331
G3600470117202,36,47,117202,72,421,493,0.14604463
G3600470117400,36,47,117400,67,343,410,0.16341463
G3600470117601,36,47,117601,94,224,318,0.29559749
G3600470117602,36,47,117602,130,171,301,0.43189368
G3600470117800,36,47,117800,118,104,222,0.53153151
G3600470118000,36,47,118000,0,0,0,
G3600470118201,36,47,118201,86,225,311,0.27652735
G3600470118202,36,47,118202,130,206,336,0.38690478
G3600470118400,36,47,118400,247,457,704,0.35085228
G3600470118600,36,47,118600,143,158,301,0.47508305
G3600470118800,36,47,118800,139,248,387,0.35917312
G3600470119000,36,47,119000,163,158,321,0.50778818
G3600470119200,36,47,119200,196,138,334,0.58682632
G3600470119400,36,47,119400,214,297,511,0.4187867
G3600470119600,36,47,119600,170,454,624,0.2724359
G3600470119800,36,47,119800,199,237,436,0.45642203
G3600470120000,36,47,120000,56,162,218,0.25688073
G3600470120200,36,47,120200,120,175,295,0.40677965
G3600470120800,36,47,120800,435,711,1146,0.37958115
G3600470121000,36,47,121000,344,215,559,0.61538464
G3600470121400,36,47,121400,393,343,736,0.53396738
G3600470122000,36,47,122000,147,503,650,0.22615385
G3600470123700,36,47,123700,119,342,461,0.25813448
G3600470150200,36,47,150200,17,250,267,0.063670412
G3600470152200,36,47,152200,54,250,304,0.17763157
G3600470990100,36,47,990100,0,0,0,
G3600490950100,36,49,950100,22,203,225,0.097777776
G3600490950200,36,49,950200,69,437,506,0.13636364
G3600490950300,36,49,950300,160,664,824,0.19417475
G3600490950400,36,49,950400,26,203,229,0.11353712
G3600490950500,36,49,950500,55,194,249,0.22088353
G3600490950600,36,49,950600,69,134,203,0.33990148
G3600490950700,36,49,950700,95,393,488,0.19467214
G3600510030100,36,51,30100,9,384,393,0.022900764
G3600510030201,36,51,30201,111,442,553,0.20072332
G3600510030202,36,51,30202,58,557,615,0.094308943
G3600510030300,36,51,30300,61,280,341,0.17888562
G3600510030400,36,51,30400,14,200,214,0.065420561
G3600510030500,36,51,30500,0,0,0,
G3600510030600,36,51,30600,79,299,378,0.20899472
G3600510030700,36,51,30700,50,749,799,0.062578224
G3600510030800,36,51,30800,69,479,548,0.12591241
G3600510030900,36,51,30900,44,208,252,0.17460318
G3600510031000,36,51,31000,0,0,0,
G3600510031100,36,51,31100,144,374,518,0.27799228
G3600510031200,36,51,31200,58,301,359,0.16155989
G3600510031300,36,51,31300,122,300,422,0.28909951
G3600510031400,36,51,31400,113,395,508,0.22244094
G3600530030101,36,53,30101,86,160,246,0.34959349
G3600530030102,36,53,30102,31,258,289,0.10726643
G3600530030103,36,53,30103,7,289,296,0.023648649
G3600530030200,36,53,30200,63,193,256,0.24609375
G3600530030300,36,53,30300,51,384,435,0.11724138
G3600530030401,36,53,30401,62,530,592,0.10472973
G3600530030402,36,53,30402,0,258,258,0
G3600530030403,36,53,30403,28,472,500,0.056000002
G3600530030501,36,53,30501,30,174,204,0.14705883
G3600530030502,36,53,30502,31,366,397,0.078085646
G3600530030600,36,53,30600,64,602,666,0.096096098
G3600530030700,36,53,30700,59,399,458,0.12882096
G3600530030800,36,53,30800,24,222,246,0.097560972
G3600530030900,36,53,30900,11,173,184,0.059782609
G3600530031000,36,53,31000,133,303,436,0.30504587
G3600530031100,36,53,31100,26,247,273,0.095238097
G3600550000200,36,55,200,231,45,276,0.8369565
G3600550000700,36,55,700,99,104,203,0.48768473
G3600550001000,36,55,1000,94,33,127,0.74015749
G3600550001300,36,55,1300,217,121,338,0.64201182
G3600550001500,36,55,1500,35,33,68,0.5147059
G3600550001800,36,55,1800,157,367,524,0.29961833
G3600550001900,36,55,1900,48,128,176,0.27272728
G3600550002000,36,55,2000,194,189,383,0.50652742
G3600550002100,36,55,2100,61,290,351,0.17378917
G3600550002200,36,55,2200,170,172,342,0.49707603
G3600550002300,36,55,2300,256,202,458,0.55895197
G3600550002400,36,55,2400,234,182,416,0.5625
G3600550002700,36,55,2700,146,104,250,0.58399999
G3600550002900,36,55,2900,42,39,81,0.51851851
G3600550003000,36,55,3000,18,63,81,0.22222222
G3600550003100,36,55,3100,0,65,65,0
G3600550003200,36,55,3200,46,48,94,0.4893617
G3600550003300,36,55,3300,23,25,48,0.47916666
G3600550003400,36,55,3400,79,77,156,0.50641024
G3600550003500,36,55,3500,33,34,67,0.49253732
G3600550003600,36,55,3600,7,144,151,0.046357617
G3600550003700,36,55,3700,86,83,169,0.50887573
G3600550003802,36,55,3802,0,0,0,
G3600550003805,36,55,3805,15,281,296,0.050675675
G3600550003900,36,55,3900,139,104,243,0.57201648
G3600550004000,36,55,4000,149,108,257,0.57976651
G3600550004100,36,55,4100,79,22,101,0.78217822
G3600550004602,36,55,4602,94,195,289,0.32525951
G3600550004701,36,55,4701,103,130,233,0.44206008
G3600550004702,36,55,4702,46,125,171,0.26900584
G3600550004800,36,55,4800,215,60,275,0.78181821
G3600550004900,36,55,4900,118,106,224,0.52678573
G3600550005000,36,55,5000,246,113,359,0.68523675
G3600550005100,36,55,5100,82,82,164,0.5
G3600550005200,36,55,5200,153,59,212,0.72169811
G3600550005300,36,55,5300,175,98,273,0.64102566
G3600550005400,36,55,5400,329,270,599,0.54924875
G3600550005500,36,55,5500,221,135,356,0.62078649
G3600550005600,36,55,5600,206,134,340,0.60588235
G3600550005700,36,55,5700,129,135,264,0.48863637
G3600550005800,36,55,5800,245,178,423,0.57919621
G3600550005900,36,55,5900,76,125,201,0.37810946
G3600550006000,36,55,6000,21,214,235,0.089361705
G3600550006100,36,55,6100,20,111,131,0.15267175
G3600550006200,36,55,6200,122,251,373,0.32707775
G3600550006300,36,55,6300,202,177,379,0.53298151
G3600550006400,36,55,6400,200,114,314,0.63694268
G3600550006500,36,55,6500,88,85,173,0.50867051
G3600550006600,36,55,6600,142,118,260,0.54615384
G3600550006700,36,55,6700,181,322,503,0.35984096
G3600550006800,36,55,6800,120,208,328,0.36585367
G3600550006900,36,55,6900,110,84,194,0.56701028
G3600550007000,36,55,7000,132,176,308,0.42857143
G3600550007100,36,55,7100,215,192,407,0.52825552
G3600550007500,36,55,7500,177,126,303,0.58415842
G3600550007600,36,55,7600,90,204,294,0.30612245
G3600550007700,36,55,7700,13,123,136,0.095588237
G3600550007801,36,55,7801,8,29,37,0.21621622
G3600550007802,36,55,7802,0,45,45,0
G3600550007900,36,55,7900,219,37,256,0.85546875
G3600550008000,36,55,8000,203,105,308,0.65909094
G3600550008100,36,55,8100,94,298,392,0.23979592
G3600550008200,36,55,8200,48,232,280,0.17142858
G3600550008301,36,55,8301,146,247,393,0.37150127
G3600550008400,36,55,8400,131,203,334,0.39221558
G3600550008500,36,55,8500,93,78,171,0.54385966
G3600550008600,36,55,8600,0,264,264,0
G3600550008701,36,55,8701,52,246,298,0.17449665
G3600550008702,36,55,8702,109,98,207,0.52657002
G3600550008800,36,55,8800,83,203,286,0.2902098
G3600550009200,36,55,9200,114,54,168,0.6785714
G3600550009301,36,55,9301,191,106,297,0.64309764
G3600550009302,36,55,9302,49,18,67,0.73134327
G3600550009400,36,55,9400,39,7,46,0.84782606
G3600550009500,36,55,9500,134,76,210,0.63809526
G3600550009601,36,55,9601,70,124,194,0.36082473
G3600550009602,36,55,9602,217,40,257,0.84435797
G3600550009603,36,55,9603,226,60,286,0.79020977
G3600550009604,36,55,9604,51,72,123,0.41463414
G3600550010100,36,55,10100,7,239,246,0.028455285
G3600550010200,36,55,10200,19,414,433,0.043879908
G3600550010300,36,55,10300,27,296,323,0.083591335
G3600550010400,36,55,10400,61,364,425,0.14352942
G3600550010500,36,55,10500,8,451,459,0.017429193
G3600550010601,36,55,10601,7,192,199,0.035175879
G3600550010602,36,55,10602,46,387,433,0.10623556
G3600550010700,36,55,10700,32,243,275,0.11636364
G3600550010800,36,55,10800,18,190,208,0.086538464
G3600550010901,36,55,10901,141,355,496,0.28427419
G3600550010902,36,55,10902,107,176,283,0.37809187
G3600550011000,36,55,11000,52,324,376,0.13829787
G3600550011100,36,55,11100,27,249,276,0.097826086
G3600550011201,36,55,11201,0,296,296,0
G3600550011203,36,55,11203,5,178,183,0.027322404
G3600550011205,36,55,11205,24,657,681,0.035242289
G3600550011207,36,55,11207,0,408,408,0
G3600550011208,36,55,11208,25,295,320,0.078125
G3600550011301,36,55,11301,40,921,961,0.041623309
G3600550011302,36,55,11302,0,489,489,0
G3600550011400,36,55,11400,249,703,952,0.26155463
G3600550011501,36,55,11501,0,696,696,0
G3600550011503,36,55,11503,15,660,675,0.022222223
G3600550011504,36,55,11504,0,667,667,0
G3600550011505,36,55,11505,36,690,726,0.049586777
G3600550011601,36,55,11601,21,592,613,0.034257747
G3600550011603,36,55,11603,22,69,91,0.24175824
G3600550011604,36,55,11604,0,171,171,0
G3600550011605,36,55,11605,0,180,180,0
G3600550011703,36,55,11703,11,841,852,0.012910798
G3600550011705,36,55,11705,0,374,374,0
G3600550011706,36,55,11706,11,524,535,0.020560747
G3600550011707,36,55,11707,74,844,918,0.080610022
G3600550011708,36,55,11708,0,307,307,0
G3600550011800,36,55,11800,0,336,336,0
G3600550011901,36,55,11901,206,442,648,0.31790122
G3600550011902,36,55,11902,39,491,530,0.073584907
G3600550012000,36,55,12000,85,176,261,0.32567051
G3600550012100,36,55,12100,80,268,348,0.22988506
G3600550012201,36,55,12201,44,301,345,0.12753624
G3600550012202,36,55,12202,38,244,282,0.13475177
G3600550012301,36,55,12301,10,670,680,0.014705882
G3600550012304,36,55,12304,19,502,521,0.036468331
G3600550012305,36,55,12305,22,611,633,0.034755133
G3600550012306,36,55,12306,26,572,598,0.043478262
G3600550012401,36,55,12401,28,361,389,0.071979433
G3600550012402,36,55,12402,25,754,779,0.032092426
G3600550012500,36,55,12500,0,266,266,0
G3600550012600,36,55,12600,0,305,305,0
G3600550012700,36,55,12700,25,436,461,0.054229934
G3600550012800,36,55,12800,0,467,467,0
G3600550012900,36,55,12900,0,559,559,0
G3600550013001,36,55,13001,81,245,326,0.24846625
G3600550013002,36,55,13002,126,453,579,0.21761657
G3600550013101,36,55,13101,50,430,480,0.10416666
G3600550013103,36,55,13103,0,128,128,0
G3600550013104,36,55,13104,0,391,391,0
G3600550013203,36,55,13203,157,441,598,0.2625418
G3600550013204,36,55,13204,70,743,813,0.086100861
G3600550013205,36,55,13205,58,360,418,0.13875598
G3600550013206,36,55,13206,99,482,581,0.17039587
G3600550013300,36,55,13300,18,268,286,0.062937066
G3600550013401,36,55,13401,43,256,299,0.14381272
G3600550013402,36,55,13402,0,313,313,0
G3600550013503,36,55,13503,0,557,557,0
G3600550013505,36,55,13505,59,278,337,0.17507419
G3600550013506,36,55,13506,65,613,678,0.095870204
G3600550013507,36,55,13507,19,580,599,0.031719532
G3600550013508,36,55,13508,7,443,450,0.015555556
G3600550013601,36,55,13601,42,416,458,0.091703057
G3600550013603,36,55,13603,0,386,386,0
G3600550013604,36,55,13604,127,343,470,0.27021277
G3600550013701,36,55,13701,29,136,165,0.17575757
G3600550013702,36,55,13702,9,306,315,0.028571429
G3600550013800,36,55,13800,232,308,540,0.42962962
G3600550013901,36,55,13901,6,312,318,0.018867925
G3600550013902,36,55,13902,86,282,368,0.23369566
G3600550014001,36,55,14001,0,317,317,0
G3600550014003,36,55,14003,44,438,482,0.091286309
G3600550014004,36,55,14004,18,220,238,0.075630255
G3600550014102,36,55,14102,57,257,314,0.18152866
G3600550014103,36,55,14103,27,262,289,0.093425609
G3600550014104,36,55,14104,82,305,387,0.2118863
G3600550014202,36,55,14202,134,472,606,0.22112212
G3600550014203,36,55,14203,212,418,630,0.33650795
G3600550014204,36,55,14204,26,190,216,0.12037037
G3600550014301,36,55,14301,81,251,332,0.24397591
G3600550014302,36,55,14302,21,500,521,0.040307101
G3600550014400,36,55,14400,0,343,343,0
G3600550014501,36,55,14501,14,388,402,0.034825869
G3600550014503,36,55,14503,67,281,348,0.19252874
G3600550014504,36,55,14504,0,470,470,0
G3600550014505,36,55,14505,79,408,487,0.16221766
G3600550014601,36,55,14601,26,420,446,0.058295965
G3600550014602,36,55,14602,54,483,537,0.10055866
G3600550014700,36,55,14700,71,400,471,0.1507431
G3600550014802,36,55,14802,71,459,530,0.13396226
G3600550014803,36,55,14803,11,388,399,0.027568921
G3600550014804,36,55,14804,86,773,859,0.10011642
G3600550014901,36,55,14901,51,583,634,0.080441639
G3600550014903,36,55,14903,39,464,503,0.077534795
G3600550014905,36,55,14905,33,522,555,0.059459459
G3600550014906,36,55,14906,0,332,332,0
G3600550015000,36,55,15000,140,402,542,0.25830257
G3600550015101,36,55,15101,38,478,516,0.073643409
G3600550015102,36,55,15102,121,357,478,0.25313807
G3600550015200,36,55,15200,91,563,654,0.13914374
G3600550015301,36,55,15301,4,0,4,1
G3600550015303,36,55,15303,0,301,301,0
G3600550015304,36,55,15304,24,248,272,0.088235296
G3600550015400,36,55,15400,0,322,322,0
G3600550980000,36,55,980000,0,0,0,
G3600550980100,36,55,980100,0,0,0,
G3600550990000,36,55,990000,0,0,0,
G3600570070200,36,57,70200,136,76,212,0.64150941
G3600570070300,36,57,70300,132,195,327,0.40366971
G3600570070400,36,57,70400,38,112,150,0.25333333
G3600570070500,36,57,70500,35,219,254,0.13779527
G3600570070600,36,57,70600,146,153,299,0.4882943
G3600570070700,36,57,70700,107,214,321,0.33333334
G3600570070800,36,57,70800,85,110,195,0.43589744
G3600570070900,36,57,70900,84,93,177,0.47457626
G3600570072100,36,57,72100,219,225,444,0.49324325
G3600570072200,36,57,72200,2,388,390,0.005128205
G3600570072300,36,57,72300,40,241,281,0.14234875
G3600570072400,36,57,72400,60,208,268,0.2238806
G3600570072500,36,57,72500,72,246,318,0.2264151
G3600570072600,36,57,72600,87,308,395,0.22025317
G3600570072700,36,57,72700,108,284,392,0.27551019
G3600570072800,36,57,72800,8,291,299,0.026755853
G3600590300100,36,59,300100,48,448,496,0.096774191
G3600590300300,36,59,300300,22,390,412,0.053398058
G3600590300400,36,59,300400,0,595,595,0
G3600590300500,36,59,300500,4,503,507,0.007889547
G3600590300600,36,59,300600,81,662,743,0.1090175
G3600590300700,36,59,300700,51,315,366,0.13934426
G3600590300800,36,59,300800,23,459,482,0.047717843
G3600590300900,36,59,300900,59,556,615,0.095934957
G3600590301000,36,59,301000,31,619,650,0.047692306
G3600590301101,36,59,301101,104,507,611,0.17021276
G3600590301102,36,59,301102,0,530,530,0
G3600590301200,36,59,301200,0,655,655,0
G3600590301300,36,59,301300,26,398,424,0.061320756
G3600590301400,36,59,301400,0,239,239,0
G3600590301500,36,59,301500,18,406,424,0.042452831
G3600590301600,36,59,301600,83,554,637,0.13029827
G3600590301700,36,59,301700,6,358,364,0.016483517
G3600590301800,36,59,301800,106,620,726,0.14600551
G3600590301900,36,59,301900,0,261,261,0
G3600590302000,36,59,302000,17,481,498,0.034136545
G3600590302101,36,59,302101,82,537,619,0.13247173
G3600590302102,36,59,302102,34,411,445,0.076404497
G3600590302200,36,59,302200,44,469,513,0.085769981
G3600590302300,36,59,302300,0,545,545,0
G3600590302400,36,59,302400,0,451,451,0
G3600590302501,36,59,302501,46,330,376,0.12234043
G3600590302502,36,59,302502,9,253,262,0.034351144
G3600590302600,36,59,302600,28,191,219,0.12785389
G3600590302700,36,59,302700,94,383,477,0.197065
G3600590302800,36,59,302800,0,589,589,0
G3600590302900,36,59,302900,46,452,498,0.092369474
G3600590303000,36,59,303000,52,533,585,0.088888891
G3600590303101,36,59,303101,0,413,413,0
G3600590303102,36,59,303102,0,496,496,0
G3600590303201,36,59,303201,24,428,452,0.053097345
G3600590303202,36,59,303202,23,349,372,0.061827958
G3600590303301,36,59,303301,32,397,429,0.074592076
G3600590303302,36,59,303302,0,399,399,0
G3600590303400,36,59,303400,4,311,315,0.012698413
G3600590303500,36,59,303500,27,404,431,0.062645011
G3600590303600,36,59,303600,126,554,680,0.18529412
G3600590303700,36,59,303700,0,727,727,0
G3600590303800,36,59,303800,136,423,559,0.24329159
G3600590303900,36,59,303900,0,424,424,0
G3600590304001,36,59,304001,0,271,271,0
G3600590304002,36,59,304002,36,316,352,0.10227273
G3600590304100,36,59,304100,165,361,526,0.31368822
G3600590304202,36,59,304202,39,318,357,0.1092437
G3600590304203,36,59,304203,52,499,551,0.094373867
G3600590304204,36,59,304204,166,395,561,0.29590017
G3600590404300,36,59,404300,0,404,404,0
G3600590404400,36,59,404400,10,468,478,0.020920502
G3600590404500,36,59,404500,0,373,373,0
G3600590404600,36,59,404600,42,415,457,0.091903716
G3600590404700,36,59,404700,0,587,587,0
G3600590404800,36,59,404800,112,637,749,0.14953271
G3600590404901,36,59,404901,27,503,530,0.050943397
G3600590404902,36,59,404902,108,330,438,0.24657534
G3600590405000,36,59,405000,72,529,601,0.11980033
G3600590405100,36,59,405100,22,662,684,0.032163743
G3600590405200,36,59,405200,111,689,800,0.13875
G3600590405301,36,59,405301,58,313,371,0.15633424
G3600590405302,36,59,405302,0,308,308,0
G3600590405400,36,59,405400,0,863,863,0
G3600590405500,36,59,405500,24,526,550,0.043636363
G3600590405600,36,59,405600,0,386,386,0
G3600590405700,36,59,405700,48,373,421,0.11401425
G3600590405800,36,59,405800,18,419,437,0.041189931
G3600590405900,36,59,405900,32,458,490,0.06530612
G3600590406001,36,59,406001,104,429,533,0.19512194
G3600590406002,36,59,406002,31,376,407,0.076167077
G3600590406100,36,59,406100,10,284,294,0.034013607
G3600590406201,36,59,406201,31,282,313,0.099041536
G3600590406202,36,59,406202,106,643,749,0.14152204
G3600590406300,36,59,406300,38,378,416,0.091346152
G3600590406400,36,59,406400,20,540,560,0.035714287
G3600590406501,36,59,406501,38,787,825,0.046060607
G3600590406600,36,59,406600,7,439,446,0.015695067
G3600590406701,36,59,406701,93,234,327,0.28440368
G3600590406702,36,59,406702,190,351,541,0.35120147
G3600590406801,36,59,406801,69,346,415,0.16626506
G3600590406802,36,59,406802,158,302,460,0.34347826
G3600590406900,36,59,406900,141,362,503,0.28031808
G3600590407000,36,59,407000,182,728,910,0.2
G3600590407101,36,59,407101,98,527,625,0.1568
G3600590407102,36,59,407102,51,581,632,0.080696203
G3600590407201,36,59,407201,206,364,570,0.3614035
G3600590407203,36,59,407203,63,312,375,0.168
G3600590407204,36,59,407204,39,193,232,0.16810344
G3600590407301,36,59,407301,9,120,129,0.069767445
G3600590407302,36,59,407302,67,358,425,0.15764706
G3600590407401,36,59,407401,51,504,555,0.091891892
G3600590407402,36,59,407402,24,302,326,0.073619634
G3600590407501,36,59,407501,39,500,539,0.072356217
G3600590407502,36,59,407502,29,517,546,0.053113554
G3600590407600,36,59,407600,22,383,405,0.054320987
G3600590407700,36,59,407700,24,539,563,0.042628776
G3600590407801,36,59,407801,94,498,592,0.15878378
G3600590407802,36,59,407802,0,17,17,0
G3600590407900,36,59,407900,0,421,421,0
G3600590408000,36,59,408000,0,566,566,0
G3600590408100,36,59,408100,74,563,637,0.11616954
G3600590408200,36,59,408200,0,631,631,0
G3600590408300,36,59,408300,33,488,521,0.063339733
G3600590408400,36,59,408400,0,339,339,0
G3600590408500,36,59,408500,0,626,626,0
G3600590408600,36,59,408600,29,425,454,0.063876651
G3600590408700,36,59,408700,7,476,483,0.014492754
G3600590408800,36,59,408800,0,610,610,0
G3600590408900,36,59,408900,7,620,627,0.011164274
G3600590409000,36,59,409000,0,644,644,0
G3600590409100,36,59,409100,9,495,504,0.017857144
G3600590409200,36,59,409200,18,655,673,0.026745914
G3600590409300,36,59,409300,9,347,356,0.025280898
G3600590409400,36,59,409400,56,501,557,0.1005386
G3600590409500,36,59,409500,10,455,465,0.021505376
G3600590409600,36,59,409600,28,498,526,0.05323194
G3600590409700,36,59,409700,0,359,359,0
G3600590409800,36,59,409800,32,605,637,0.05023548
G3600590409900,36,59,409900,99,726,825,0.12
G3600590410000,36,59,410000,0,346,346,0
G3600590410100,36,59,410100,0,488,488,0
G3600590410200,36,59,410200,29,275,304,0.095394738
G3600590410300,36,59,410300,65,617,682,0.095307916
G3600590410400,36,59,410400,24,454,478,0.050209206
G3600590410500,36,59,410500,239,797,1036,0.23069498
G3600590410600,36,59,410600,125,780,905,0.13812155
G3600590410700,36,59,410700,81,638,719,0.11265647
G3600590410800,36,59,410800,18,417,435,0.04137931
G3600590410900,36,59,410900,0,595,595,0
G3600590411000,36,59,411000,97,531,628,0.1544586
G3600590411100,36,59,411100,178,369,547,0.32541132
G3600590411200,36,59,411200,34,562,596,0.05704698
G3600590411301,36,59,411301,0,394,394,0
G3600590411302,36,59,411302,18,750,768,0.0234375
G3600590411400,36,59,411400,147,554,701,0.20970044
G3600590411500,36,59,411500,2,298,300,0.006666667
G3600590411600,36,59,411600,16,525,541,0.029574862
G3600590411700,36,59,411700,0,506,506,0
G3600590411800,36,59,411800,0,586,586,0
G3600590411901,36,59,411901,36,283,319,0.11285266
G3600590411902,36,59,411902,24,412,436,0.055045873
G3600590412000,36,59,412000,78,632,710,0.10985915
G3600590412100,36,59,412100,15,552,567,0.026455026
G3600590412200,36,59,412200,12,580,592,0.020270269
G3600590412301,36,59,412301,0,291,291,0
G3600590412302,36,59,412302,22,283,305,0.072131149
G3600590412400,36,59,412400,95,415,510,0.18627451
G3600590412500,36,59,412500,9,523,532,0.016917294
G3600590412600,36,59,412600,75,406,481,0.15592515
G3600590412700,36,59,412700,0,395,395,0
G3600590412800,36,59,412800,8,324,332,0.024096385
G3600590412900,36,59,412900,10,629,639,0.015649453
G3600590413001,36,59,413001,121,279,400,0.30250001
G3600590413002,36,59,413002,16,339,355,0.045070421
G3600590413100,36,59,413100,52,504,556,0.093525179
G3600590413200,36,59,413200,28,445,473,0.059196617
G3600590413300,36,59,413300,42,550,592,0.070945948
G3600590413400,36,59,413400,35,577,612,0.057189543
G3600590413500,36,59,413500,34,1015,1049,0.032411821
G3600590413600,36,59,413600,101,442,543,0.18600368
G3600590413700,36,59,413700,145,480,625,0.23199999
G3600590413803,36,59,413803,12,388,400,0.029999999
G3600590413804,36,59,413804,26,364,390,0.06666667
G3600590413900,36,59,413900,266,731,997,0.2668004
G3600590414001,36,59,414001,20,307,327,0.061162081
G3600590414002,36,59,414002,104,431,535,0.19439252
G3600590414100,36,59,414100,72,461,533,0.13508442
G3600590414201,36,59,414201,150,534,684,0.21929824
G3600590414202,36,59,414202,73,380,453,0.16114791
G3600590414301,36,59,414301,20,262,282,0.070921987
G3600590414303,36,59,414303,22,406,428,0.051401868
G3600590414304,36,59,414304,71,356,427,0.16627635
G3600590414400,36,59,414400,196,378,574,0.34146342
G3600590414501,36,59,414501,0,371,371,0
G3600590414502,36,59,414502,12,249,261,0.045977011
G3600590414600,36,59,414600,52,373,425,0.12235294
G3600590414700,36,59,414700,36,449,485,0.074226804
G3600590414800,36,59,414800,14,679,693,0.02020202
G3600590414900,36,59,414900,88,663,751,0.1171771
G3600590415000,36,59,415000,57,652,709,0.080394924
G3600590415101,36,59,415101,6,258,264,0.022727273
G3600590415102,36,59,415102,0,459,459,0
G3600590415201,36,59,415201,0,361,361,0
G3600590415202,36,59,415202,0,392,392,0
G3600590415300,36,59,415300,12,463,475,0.025263159
G3600590415401,36,59,415401,32,543,575,0.055652175
G3600590415402,36,59,415402,0,455,455,0
G3600590415500,36,59,415500,9,215,224,0.040178571
G3600590415600,36,59,415600,36,561,597,0.060301509
G3600590415700,36,59,415700,0,684,684,0
G3600590415802,36,59,415802,0,799,799,0
G3600590416000,36,59,416000,24,353,377,0.06366048
G3600590416100,36,59,416100,66,631,697,0.094691537
G3600590416201,36,59,416201,0,354,354,0
G3600590416202,36,59,416202,137,255,392,0.34948981
G3600590416300,36,59,416300,21,236,257,0.08171206
G3600590416401,36,59,416401,0,231,231,0
G3600590416402,36,59,416402,29,209,238,0.12184874
G3600590416500,36,59,416500,61,601,662,0.092145018
G3600590416600,36,59,416600,31,347,378,0.082010582
G3600590416701,36,59,416701,0,374,374,0
G3600590416702,36,59,416702,0,182,182,0
G3600590416801,36,59,416801,24,199,223,0.10762332
G3600590416802,36,59,416802,118,166,284,0.41549295
G3600590416900,36,59,416900,10,403,413,0.024213076
G3600590517000,36,59,517000,12,192,204,0.05882353
G3600590517101,36,59,517101,53,389,442,0.1199095
G3600590517102,36,59,517102,17,184,201,0.084577113
G3600590517200,36,59,517200,480,631,1111,0.43204319
G3600590517301,36,59,517301,36,86,122,0.29508197
G3600590517302,36,59,517302,21,392,413,0.050847456
G3600590517400,36,59,517400,14,505,519,0.026974952
G3600590517500,36,59,517500,0,308,308,0
G3600590517600,36,59,517600,0,442,442,0
G3600590517701,36,59,517701,58,771,829,0.069963813
G3600590517705,36,59,517705,12,364,376,0.031914894
G3600590517801,36,59,517801,13,323,336,0.038690478
G3600590517802,36,59,517802,8,331,339,0.02359882
G3600590517901,36,59,517901,20,497,517,0.038684718
G3600590517902,36,59,517902,62,171,233,0.26609442
G3600590518000,36,59,518000,0,674,674,0
G3600590518100,36,59,518100,39,282,321,0.12149533
G3600590518201,36,59,518201,26,495,521,0.04990403
G3600590518203,36,59,518203,32,294,326,0.098159507
G3600590518204,36,59,518204,0,376,376,0
G3600590518300,36,59,518300,39,573,612,0.063725494
G3600590518400,36,59,518400,0,592,592,0
G3600590518501,36,59,518501,45,776,821,0.054811206
G3600590518502,36,59,518502,47,309,356,0.13202247
G3600590518600,36,59,518600,20,501,521,0.038387716
G3600590518700,36,59,518700,45,649,694,0.064841501
G3600590518800,36,59,518800,16,504,520,0.030769231
G3600590518900,36,59,518900,9,618,627,0.014354067
G3600590519000,36,59,519000,18,485,503,0.035785288
G3600590519100,36,59,519100,0,406,406,0
G3600590519200,36,59,519200,79,484,563,0.14031972
G3600590519300,36,59,519300,11,520,531,0.020715632
G3600590519400,36,59,519400,30,383,413,0.072639227
G3600590519500,36,59,519500,50,594,644,0.077639751
G3600590519601,36,59,519601,14,472,486,0.028806584
G3600590519602,36,59,519602,0,202,202,0
G3600590519702,36,59,519702,18,610,628,0.028662421
G3600590519703,36,59,519703,0,347,347,0
G3600590519704,36,59,519704,18,330,348,0.05172414
G3600590519801,36,59,519801,6,285,291,0.020618556
G3600590519802,36,59,519802,56,593,649,0.086286597
G3600590519900,36,59,519900,0,486,486,0
G3600590520001,36,59,520001,0,721,721,0
G3600590520002,36,59,520002,24,345,369,0.065040648
G3600590520100,36,59,520100,28,478,506,0.055335969
G3600590520200,36,59,520200,0,270,270,0
G3600590520300,36,59,520300,44,584,628,0.070063695
G3600590520401,36,59,520401,20,278,298,0.067114092
G3600590520402,36,59,520402,10,415,425,0.023529412
G3600590520501,36,59,520501,32,389,421,0.076009504
G3600590520502,36,59,520502,0,433,433,0
G3600590520600,36,59,520600,37,717,754,0.049071617
G3600590520700,36,59,520700,0,561,561,0
G3600590520800,36,59,520800,45,433,478,0.094142258
G3600590520900,36,59,520900,16,385,401,0.039900251
G3600590521000,36,59,521000,110,357,467,0.23554604
G3600590521100,36,59,521100,19,480,499,0.038076151
G3600590521200,36,59,521200,4,225,229,0.017467249
G3600590521301,36,59,521301,0,199,199,0
G3600590521302,36,59,521302,20,595,615,0.032520324
G3600590521400,36,59,521400,0,792,792,0
G3600590521500,36,59,521500,0,468,468,0
G3600590521601,36,59,521601,0,402,402,0
G3600590521602,36,59,521602,0,294,294,0
G3600590521700,36,59,521700,51,439,490,0.10408163
G3600590521801,36,59,521801,19,313,332,0.057228915
G3600590521802,36,59,521802,48,395,443,0.10835215
G3600590521902,36,59,521902,0,474,474,0
G3600590522000,36,59,522000,106,411,517,0.20502901
G3600590522700,36,59,522700,6,473,479,0.012526096
G3600590980100,36,59,980100,0,0,0,
G3600590981100,36,59,981100,0,0,0,
G3600590982100,36,59,982100,0,0,0,
G3600590990100,36,59,990100,0,0,0,
G3600590990200,36,59,990200,0,0,0,
G3600590990301,36,59,990301,0,0,0,
G3600590990302,36,59,990302,0,0,0,
G3600590990400,36,59,990400,0,0,0,
G3600610000100,36,61,100,0,0,0,
G3600610000201,36,61,201,243,48,291,0.83505154
G3600610000202,36,61,202,77,654,731,0.10533515
G3600610000500,36,61,500,0,0,0,
G3600610000600,36,61,600,547,688,1235,0.44291499
G3600610000700,36,61,700,0,391,391,0
G3600610000800,36,61,800,343,609,952,0.3602941
G3600610000900,36,61,900,12,73,85,0.14117648
G3600610001001,36,61,1001,0,101,101,0
G3600610001002,36,61,1002,282,368,650,0.43384615
G3600610001200,36,61,1200,25,282,307,0.081433222
G3600610001300,36,61,1300,0,129,129,0
G3600610001401,36,61,1401,16,141,157,0.10191083
G3600610001402,36,61,1402,85,59,144,0.59027779
G3600610001501,36,61,1501,0,205,205,0
G3600610001502,36,61,1502,0,139,139,0
G3600610001600,36,61,1600,570,212,782,0.72890025
G3600610001800,36,61,1800,253,214,467,0.54175591
G3600610002000,36,61,2000,354,135,489,0.72392637
G3600610002100,36,61,2100,49,586,635,0.077165358
G3600610002201,36,61,2201,201,192,393,0.51145041
G3600610002202,36,61,2202,17,48,65,0.26153848
G3600610002400,36,61,2400,366,138,504,0.72619045
G3600610002500,36,61,2500,303,261,564,0.53723407
G3600610002601,36,61,2601,84,231,315,0.26666668
G3600610002602,36,61,2602,0,318,318,0
G3600610002700,36,61,2700,15,65,80,0.1875
G3600610002800,36,61,2800,402,314,716,0.56145251
G3600610002900,36,61,2900,64,140,204,0.3137255
G3600610003001,36,61,3001,102,60,162,0.62962961
G3600610003002,36,61,3002,52,65,117,0.44444445
G3600610003100,36,61,3100,14,73,87,0.16091955
G3600610003200,36,61,3200,0,345,345,0
G3600610003300,36,61,3300,0,406,406,0
G3600610003400,36,61,3400,183,91,274,0.66788322
G3600610003601,36,61,3601,115,118,233,0.49356222
G3600610003602,36,61,3602,23,11,34,0.67647058
G3600610003700,36,61,3700,0,204,204,0
G3600610003800,36,61,3800,0,184,184,0
G3600610003900,36,61,3900,53,388,441,0.1201814
G3600610004000,36,61,4000,0,178,178,0
G3600610004100,36,61,4100,303,274,577,0.52512997
G3600610004200,36,61,4200,33,150,183,0.18032786
G3600610004300,36,61,4300,90,59,149,0.60402685
G3600610004400,36,61,4400,0,751,751,0
G3600610004500,36,61,4500,0,118,118,0
G3600610004700,36,61,4700,66,93,159,0.41509435
G3600610004800,36,61,4800,0,193,193,0
G3600610004900,36,61,4900,0,130,130,0
G3600610005000,36,61,5000,23,176,199,0.11557789
G3600610005200,36,61,5200,26,111,137,0.18978103
G3600610005400,36,61,5400,0,182,182,0
G3600610005501,36,61,5501,0,234,234,0
G3600610005502,36,61,5502,0,86,86,0
G3600610005600,36,61,5600,0,34,34,0
G3600610005700,36,61,5700,0,148,148,0
G3600610005800,36,61,5800,0,87,87,0
G3600610005900,36,61,5900,0,111,111,0
G3600610006000,36,61,6000,0,232,232,0
G3600610006100,36,61,6100,0,180,180,0
G3600610006200,36,61,6200,8,154,162,0.049382716
G3600610006300,36,61,6300,0,263,263,0
G3600610006400,36,61,6400,82,53,135,0.60740739
G3600610006500,36,61,6500,0,82,82,0
G3600610006600,36,61,6600,64,438,502,0.12749004
G3600610006700,36,61,6700,0,154,154,0
G3600610006800,36,61,6800,0,150,150,0
G3600610006900,36,61,6900,16,71,87,0.18390805
G3600610007000,36,61,7000,46,121,167,0.2754491
G3600610007100,36,61,7100,0,225,225,0
G3600610007200,36,61,7200,0,101,101,0
G3600610007300,36,61,7300,0,144,144,0
G3600610007400,36,61,7400,16,69,85,0.1882353
G3600610007500,36,61,7500,0,201,201,0
G3600610007600,36,61,7600,14,67,81,0.17283951
G3600610007700,36,61,7700,7,137,144,0.048611112
G3600610007800,36,61,7800,0,112,112,0
G3600610007900,36,61,7900,22,250,272,0.080882356
G3600610008000,36,61,8000,15,184,199,0.075376883
G3600610008100,36,61,8100,46,523,569,0.080843583
G3600610008200,36,61,8200,0,106,106,0
G3600610008300,36,61,8300,54,293,347,0.15561959
G3600610008400,36,61,8400,0,28,28,0
G3600610008601,36,61,8601,0,119,119,0
G3600610008602,36,61,8602,0,0,0,
G3600610008603,36,61,8603,7,156,163,0.042944785
G3600610008700,36,61,8700,29,240,269,0.10780669
G3600610008800,36,61,8800,44,188,232,0.18965517
G3600610008900,36,61,8900,67,187,254,0.26377952
G3600610009000,36,61,9000,0,138,138,0
G3600610009100,36,61,9100,124,189,313,0.39616615
G3600610009200,36,61,9200,7,24,31,0.22580644
G3600610009300,36,61,9300,497,238,735,0.6761905
G3600610009400,36,61,9400,0,0,0,
G3600610009500,36,61,9500,9,105,114,0.078947365
G3600610009600,36,61,9600,0,4,4,0
G3600610009700,36,61,9700,105,188,293,0.35836178
G3600610009800,36,61,9800,0,135,135,0
G3600610009900,36,61,9900,0,128,128,0
G3600610010000,36,61,10000,0,37,37,0
G3600610010100,36,61,10100,0,34,34,0
G3600610010200,36,61,10200,0,3,3,0
G3600610010300,36,61,10300,6,10,16,0.375
G3600610010400,36,61,10400,0,22,22,0
G3600610010601,36,61,10601,0,125,125,0
G3600610010602,36,61,10602,0,224,224,0
G3600610010800,36,61,10800,0,212,212,0
G3600610010900,36,61,10900,6,0,6,1
G3600610011000,36,61,11000,0,302,302,0
G3600610011100,36,61,11100,51,84,135,0.37777779
G3600610011201,36,61,11201,0,15,15,0
G3600610011202,36,61,11202,0,10,10,0
G3600610011203,36,61,11203,13,27,40,0.32499999
G3600610011300,36,61,11300,0,0,0,
G3600610011401,36,61,11401,0,106,106,0
G3600610011402,36,61,11402,9,139,148,0.060810812
G3600610011500,36,61,11500,0,27,27,0
G3600610011600,36,61,11600,0,69,69,0
G3600610011700,36,61,11700,31,108,139,0.22302158
G3600610011800,36,61,11800,0,632,632,0
G3600610011900,36,61,11900,0,0,0,
G3600610012000,36,61,12000,0,152,152,0
G3600610012100,36,61,12100,15,217,232,0.06465517
G3600610012200,36,61,12200,0,202,202,0
G3600610012400,36,61,12400,0,832,832,0
G3600610012500,36,61,12500,0,40,40,0
G3600610012600,36,61,12600,0,662,662,0
G3600610012700,36,61,12700,10,139,149,0.067114092
G3600610012800,36,61,12800,36,428,464,0.077586204
G3600610012900,36,61,12900,0,152,152,0
G3600610013000,36,61,13000,0,256,256,0
G3600610013100,36,61,13100,0,27,27,0
G3600610013200,36,61,13200,0,377,377,0
G3600610013300,36,61,13300,0,117,117,0
G3600610013400,36,61,13400,314,555,869,0.36133486
G3600610013500,36,61,13500,67,144,211,0.31753555
G3600610013600,36,61,13600,0,906,906,0
G3600610013700,36,61,13700,60,312,372,0.16129032
G3600610013800,36,61,13800,0,538,538,0
G3600610013900,36,61,13900,0,85,85,0
G3600610014000,36,61,14000,80,518,598,0.13377926
G3600610014200,36,61,14200,49,376,425,0.11529412
G3600610014300,36,61,14300,0,0,0,
G3600610014401,36,61,14401,0,421,421,0
G3600610014402,36,61,14402,0,403,403,0
G3600610014500,36,61,14500,0,222,222,0
G3600610014601,36,61,14601,0,214,214,0
G3600610014602,36,61,14602,24,369,393,0.061068702
G3600610014700,36,61,14700,5,106,111,0.045045044
G3600610014801,36,61,14801,13,223,236,0.055084746
G3600610014802,36,61,14802,13,578,591,0.021996615
G3600610014900,36,61,14900,40,360,400,0.1
G3600610015001,36,61,15001,50,188,238,0.21008404
G3600610015002,36,61,15002,27,495,522,0.05172414
G3600610015100,36,61,15100,171,260,431,0.39675173
G3600610015200,36,61,15200,46,446,492,0.093495935
G3600610015300,36,61,15300,0,474,474,0
G3600610015400,36,61,15400,0,981,981,0
G3600610015500,36,61,15500,50,565,615,0.08130081
G3600610015601,36,61,15601,60,165,225,0.26666668
G3600610015602,36,61,15602,52,137,189,0.27513227
G3600610015700,36,61,15700,0,442,442,0
G3600610015801,36,61,15801,45,408,453,0.099337749
G3600610015802,36,61,15802,7,171,178,0.039325844
G3600610015900,36,61,15900,0,512,512,0
G3600610016001,36,61,16001,8,483,491,0.01629328
G3600610016002,36,61,16002,0,199,199,0
G3600610016100,36,61,16100,0,339,339,0
G3600610016200,36,61,16200,487,462,949,0.51317173
G3600610016300,36,61,16300,31,412,443,0.069977425
G3600610016400,36,61,16400,173,408,581,0.29776248
G3600610016500,36,61,16500,0,424,424,0
G3600610016600,36,61,16600,123,411,534,0.23033708
G3600610016700,36,61,16700,58,494,552,0.10507246
G3600610016800,36,61,16800,224,277,501,0.4471058
G3600610016900,36,61,16900,0,547,547,0
G3600610017000,36,61,17000,192,404,596,0.32214764
G3600610017100,36,61,17100,0,587,587,0
G3600610017200,36,61,17200,195,459,654,0.29816514
G3600610017300,36,61,17300,0,279,279,0
G3600610017401,36,61,17401,208,273,481,0.43243244
G3600610017402,36,61,17402,70,131,201,0.3482587
G3600610017500,36,61,17500,0,890,890,0
G3600610017700,36,61,17700,329,535,864,0.38078704
G3600610017800,36,61,17800,139,213,352,0.39488637
G3600610017900,36,61,17900,193,563,756,0.25529101
G3600610018000,36,61,18000,227,587,814,0.27886978
G3600610018100,36,61,18100,32,571,603,0.053067993
G3600610018200,36,61,18200,613,420,1033,0.59341723
G3600610018300,36,61,18300,0,405,405,0
G3600610018400,36,61,18400,297,481,778,0.38174808
G3600610018500,36,61,18500,0,340,340,0
G3600610018600,36,61,18600,326,382,708,0.46045199
G3600610018700,36,61,18700,100,509,609,0.16420361
G3600610018800,36,61,18800,91,268,359,0.25348189
G3600610018900,36,61,18900,291,650,941,0.3092455
G3600610019000,36,61,19000,51,280,331,0.15407854
G3600610019100,36,61,19100,80,488,568,0.14084508
G3600610019200,36,61,19200,394,252,646,0.60990715
G3600610019300,36,61,19300,169,374,543,0.31123388
G3600610019400,36,61,19400,298,244,542,0.54981548
G3600610019500,36,61,19500,12,560,572,0.020979021
G3600610019600,36,61,19600,117,181,298,0.39261746
G3600610019701,36,61,19701,20,21,41,0.48780489
G3600610019702,36,61,19702,36,71,107,0.33644861
G3600610019800,36,61,19800,18,123,141,0.12765957
G3600610019900,36,61,19900,0,368,368,0
G3600610020000,36,61,20000,16,233,249,0.064257026
G3600610020101,36,61,20101,0,58,58,0
G3600610020102,36,61,20102,107,286,393,0.27226463
G3600610020300,36,61,20300,0,34,34,0
G3600610020500,36,61,20500,0,237,237,0
G3600610020600,36,61,20600,35,187,222,0.15765765
G3600610020701,36,61,20701,0,99,99,0
G3600610020800,36,61,20800,205,262,467,0.43897218
G3600610020901,36,61,20901,183,221,404,0.4529703
G3600610021000,36,61,21000,422,531,953,0.44281217
G3600610021100,36,61,21100,68,540,608,0.1118421
G3600610021200,36,61,21200,0,292,292,0
G3600610021303,36,61,21303,191,217,408,0.46813726
G3600610021400,36,61,21400,47,39,86,0.54651165
G3600610021500,36,61,21500,104,296,400,0.25999999
G3600610021600,36,61,21600,90,585,675,0.13333334
G3600610021703,36,61,21703,0,0,0,
G3600610021800,36,61,21800,219,228,447,0.48993289
G3600610021900,36,61,21900,396,217,613,0.64600325
G3600610022000,36,61,22000,120,280,400,0.30000001
G3600610022102,36,61,22102,16,138,154,0.1038961
G3600610022200,36,61,22200,145,143,288,0.50347221
G3600610022301,36,61,22301,248,367,615,0.40325204
G3600610022302,36,61,22302,93,181,274,0.33941606
G3600610022400,36,61,22400,579,400,979,0.59141982
G3600610022500,36,61,22500,207,665,872,0.23738532
G3600610022600,36,61,22600,205,217,422,0.485782
G3600610022700,36,61,22700,76,350,426,0.17840375
G3600610022800,36,61,22800,158,356,514,0.30739298
G3600610022900,36,61,22900,289,394,683,0.42313322
G3600610023000,36,61,23000,155,549,704,0.22017045
G3600610023100,36,61,23100,119,396,515,0.23106796
G3600610023200,36,61,23200,212,532,744,0.28494623
G3600610023300,36,61,23300,262,289,551,0.47549909
G3600610023400,36,61,23400,210,262,472,0.44491526
G3600610023501,36,61,23501,409,212,621,0.65861511
G3600610023502,36,61,23502,35,129,164,0.21341464
G3600610023600,36,61,23600,47,531,578,0.081314877
G3600610023700,36,61,23700,145,460,605,0.23966943
G3600610023801,36,61,23801,69,427,496,0.1391129
G3600610023802,36,61,23802,13,78,91,0.14285715
G3600610023900,36,61,23900,118,156,274,0.43065694
G3600610024000,36,61,24000,0,0,0,
G3600610024100,36,61,24100,209,316,525,0.39809525
G3600610024200,36,61,24200,228,315,543,0.41988951
G3600610024301,36,61,24301,153,144,297,0.5151515
G3600610024302,36,61,24302,676,466,1142,0.59194398
G3600610024500,36,61,24500,474,557,1031,0.45974782
G3600610024700,36,61,24700,193,431,624,0.30929488
G3600610024900,36,61,24900,39,76,115,0.33913043
G3600610025100,36,61,25100,75,132,207,0.36231884
G3600610025300,36,61,25300,210,471,681,0.30837005
G3600610025500,36,61,25500,30,151,181,0.16574585
G3600610025700,36,61,25700,46,422,468,0.0982906
G3600610025900,36,61,25900,138,242,380,0.3631579
G3600610026100,36,61,26100,416,713,1129,0.36846766
G3600610026300,36,61,26300,427,326,753,0.56706506
G3600610026500,36,61,26500,138,298,436,0.31651375
G3600610026700,36,61,26700,57,71,128,0.4453125
G3600610026900,36,61,26900,188,463,651,0.28878647
G3600610027100,36,61,27100,341,478,819,0.41636142
G3600610027300,36,61,27300,126,371,497,0.25352111
G3600610027500,36,61,27500,55,289,344,0.15988372
G3600610027700,36,61,27700,365,247,612,0.59640521
G3600610027900,36,61,27900,225,650,875,0.25714287
G3600610028100,36,61,28100,0,208,208,0
G3600610028300,36,61,28300,120,577,697,0.17216642
G3600610028500,36,61,28500,299,356,655,0.45648855
G3600610028700,36,61,28700,64,269,333,0.1921922
G3600610029100,36,61,29100,394,860,1254,0.31419459
G3600610029300,36,61,29300,545,465,1010,0.53960395
G3600610029500,36,61,29500,162,435,597,0.27135679
G3600610029700,36,61,29700,0,0,0,
G3600610029900,36,61,29900,187,310,497,0.37625754
G3600610030300,36,61,30300,124,262,386,0.32124352
G3600610030700,36,61,30700,0,210,210,0
G3600610030900,36,61,30900,389,648,1037,0.37512055
G3600610031100,36,61,31100,0,0,0,
G3600610031703,36,61,31703,30,635,665,0.045112781
G3600610031704,36,61,31704,56,634,690,0.08115942
G3600610031900,36,61,31900,0,0,0,
G3600630020100,36,63,20100,79,206,285,0.27719298
G3600630020200,36,63,20200,307,84,391,0.78516626
G3600630020300,36,63,20300,89,133,222,0.4009009
G3600630020400,36,63,20400,61,91,152,0.40131578
G3600630020500,36,63,20500,87,51,138,0.63043481
G3600630020600,36,63,20600,24,109,133,0.18045112
G3600630020700,36,63,20700,203,158,361,0.56232685
G3600630020900,36,63,20900,257,112,369,0.69647694
G3600630021000,36,63,21000,73,109,182,0.40109891
G3600630021100,36,63,21100,49,57,106,0.46226415
G3600630021200,36,63,21200,0,106,106,0
G3600630021300,36,63,21300,77,101,178,0.43258426
G3600630021400,36,63,21400,46,125,171,0.26900584
G3600630021700,36,63,21700,189,265,454,0.41629955
G3600630022000,36,63,22000,82,261,343,0.23906706
G3600630022100,36,63,22100,40,247,287,0.13937283
G3600630022200,36,63,22200,43,245,288,0.14930555
G3600630022300,36,63,22300,33,207,240,0.1375
G3600630022401,36,63,22401,0,174,174,0
G3600630022500,36,63,22500,14,176,190,0.073684208
G3600630022601,36,63,22601,71,217,288,0.24652778
G3600630022602,36,63,22602,42,367,409,0.10268949
G3600630022702,36,63,22702,14,575,589,0.023769099
G3600630022711,36,63,22711,15,1023,1038,0.014450867
G3600630022712,36,63,22712,0,636,636,0
G3600630022803,36,63,22803,0,253,253,0
G3600630022804,36,63,22804,20,300,320,0.0625
G3600630022901,36,63,22901,0,135,135,0
G3600630022902,36,63,22902,17,159,176,0.096590906
G3600630023001,36,63,23001,12,132,144,0.083333336
G3600630023100,36,63,23100,23,142,165,0.13939394
G3600630023200,36,63,23200,52,176,228,0.22807017
G3600630023300,36,63,23300,156,396,552,0.28260869
G3600630023401,36,63,23401,106,505,611,0.17348608
G3600630023402,36,63,23402,30,383,413,0.072639227
G3600630023404,36,63,23404,10,584,594,0.016835017
G3600630023405,36,63,23405,43,254,297,0.14478114
G3600630023500,36,63,23500,108,139,247,0.43724698
G3600630023600,36,63,23600,116,312,428,0.27102804
G3600630023700,36,63,23700,9,50,59,0.15254237
G3600630023800,36,63,23800,69,286,355,0.1943662
G3600630023901,36,63,23901,22,427,449,0.048997771
G3600630023902,36,63,23902,0,416,416,0
G3600630024001,36,63,24001,127,526,653,0.19448699
G3600630024002,36,63,24002,18,194,212,0.084905662
G3600630024101,36,63,24101,34,348,382,0.089005239
G3600630024102,36,63,24102,50,288,338,0.147929
G3600630024201,36,63,24201,90,553,643,0.1399689
G3600630024202,36,63,24202,85,250,335,0.25373134
G3600630024301,36,63,24301,17,76,93,0.1827957
G3600630024302,36,63,24302,79,430,509,0.15520629
G3600630024303,36,63,24303,34,539,573,0.059336822
G3600630024401,36,63,24401,6,273,279,0.021505376
G3600630024404,36,63,24404,18,287,305,0.059016392
G3600630024405,36,63,24405,26,487,513,0.050682262
G3600630024406,36,63,24406,0,177,177,0
G3600630024501,36,63,24501,9,327,336,0.026785715
G3600630024502,36,63,24502,32,204,236,0.13559322
G3600630024600,36,63,24600,17,472,489,0.034764826
G3600630940001,36,63,940001,45,81,126,0.35714287
G3600630940100,36,63,940100,0,0,0,
G3600630990000,36,63,990000,0,0,0,
G3600650020102,36,65,20102,55,44,99,0.55555558
G3600650020300,36,65,20300,44,13,57,0.7719298
G3600650020705,36,65,20705,42,170,212,0.1981132
G3600650020802,36,65,20802,264,364,628,0.42038217
G3600650020803,36,65,20803,229,134,363,0.63085401
G3600650020900,36,65,20900,127,60,187,0.67914438
G3600650021000,36,65,21000,116,74,190,0.61052632
G3600650021101,36,65,21101,56,83,139,0.40287769
G3600650021102,36,65,21102,181,100,281,0.64412808
G3600650021103,36,65,21103,43,71,114,0.37719297
G3600650021201,36,65,21201,104,88,192,0.54166669
G3600650021202,36,65,21202,293,157,450,0.65111113
G3600650021301,36,65,21301,64,137,201,0.31840795
G3600650021302,36,65,21302,115,229,344,0.33430234
G3600650021303,36,65,21303,0,168,168,0
G3600650021401,36,65,21401,141,137,278,0.50719422
G3600650021402,36,65,21402,112,87,199,0.56281406
G3600650021500,36,65,21500,162,175,337,0.48071218
G3600650021601,36,65,21601,43,438,481,0.089397088
G3600650021602,36,65,21602,0,98,98,0
G3600650021701,36,65,21701,0,181,181,0
G3600650021702,36,65,21702,25,186,211,0.11848341
G3600650021900,36,65,21900,85,170,255,0.33333334
G3600650022000,36,65,22000,174,175,349,0.49856734
G3600650022100,36,65,22100,66,236,302,0.21854305
G3600650022200,36,65,22200,0,286,286,0
G3600650022400,36,65,22400,33,194,227,0.14537445
G3600650022500,36,65,22500,97,218,315,0.30793652
G3600650022701,36,65,22701,0,164,164,0
G3600650022702,36,65,22702,48,245,293,0.16382253
G3600650022800,36,65,22800,14,233,247,0.056680162
G3600650023000,36,65,23000,37,624,661,0.055975795
G3600650023200,36,65,23200,28,454,482,0.058091287
G3600650023300,36,65,23300,32,181,213,0.15023474
G3600650023400,36,65,23400,64,420,484,0.1322314
G3600650023501,36,65,23501,0,256,256,0
G3600650023502,36,65,23502,11,411,422,0.02606635
G3600650023702,36,65,23702,71,281,352,0.20170455
G3600650023901,36,65,23901,5,258,263,0.019011406
G3600650023902,36,65,23902,18,229,247,0.072874494
G3600650024000,36,65,24000,29,438,467,0.062098499
G3600650024101,36,65,24101,35,60,95,0.36842105
G3600650024102,36,65,24102,30,216,246,0.12195122
G3600650024200,36,65,24200,111,344,455,0.24395604
G3600650024301,36,65,24301,0,242,242,0
G3600650024302,36,65,24302,11,333,344,0.031976745
G3600650024303,36,65,24303,45,189,234,0.1923077
G3600650024400,36,65,24400,41,321,362,0.11325967
G3600650024500,36,65,24500,132,475,607,0.21746293
G3600650024700,36,65,24700,164,550,714,0.22969188
G3600650024800,36,65,24800,19,270,289,0.065743946
G3600650024900,36,65,24900,55,474,529,0.10396975
G3600650025001,36,65,25001,36,217,253,0.14229248
G3600650025002,36,65,25002,30,304,334,0.089820363
G3600650025003,36,65,25003,8,114,122,0.065573767
G3600650025100,36,65,25100,44,177,221,0.19909503
G3600650025200,36,65,25200,18,219,237,0.075949363
G3600650025300,36,65,25300,26,675,701,0.037089873
G3600650025400,36,65,25400,13,503,516,0.025193799
G3600650025500,36,65,25500,17,345,362,0.046961326
G3600650025600,36,65,25600,23,340,363,0.063360885
G3600650025700,36,65,25700,27,168,195,0.13846155
G3600650025800,36,65,25800,29,103,132,0.21969697
G3600650025900,36,65,25900,0,0,0,
G3600650026100,36,65,26100,4,220,224,0.017857144
G3600650026200,36,65,26200,27,614,641,0.042121686
G3600650026300,36,65,26300,58,248,306,0.18954249
G3600650026400,36,65,26400,424,261,685,0.61897808
G3600650026500,36,65,26500,0,0,0,
G3600650026600,36,65,26600,0,0,0,
G3600650026700,36,65,26700,107,353,460,0.23260869
G3600650980002,36,65,980002,0,0,0,
G3600650980003,36,65,980003,0,0,0,
G3600650980100,36,65,980100,0,0,0,
G3600670000100,36,67,100,26,4,30,0.86666667
G3600670000200,36,67,200,178,120,298,0.59731543
G3600670000300,36,67,300,29,94,123,0.23577236
G3600670000400,36,67,400,108,166,274,0.3941606
G3600670000501,36,67,501,94,121,215,0.43720931
G3600670000600,36,67,600,176,226,402,0.43781096
G3600670000700,36,67,700,27,106,133,0.20300752
G3600670000800,36,67,800,89,226,315,0.2825397
G3600670000900,36,67,900,71,127,198,0.35858586
G3600670001000,36,67,1000,162,292,454,0.35682818
G3600670001400,36,67,1400,201,133,334,0.60179639
G3600670001500,36,67,1500,246,183,429,0.57342654
G3600670001600,36,67,1600,33,37,70,0.47142857
G3600670001701,36,67,1701,123,80,203,0.60591131
G3600670001702,36,67,1702,26,158,184,0.14130434
G3600670001800,36,67,1800,43,104,147,0.29251701
G3600670001900,36,67,1900,27,193,220,0.12272727
G3600670002000,36,67,2000,56,166,222,0.25225225
G3600670002101,36,67,2101,256,123,379,0.67546177
G3600670002300,36,67,2300,35,32,67,0.52238804
G3600670002400,36,67,2400,159,91,250,0.63599998
G3600670002700,36,67,2700,47,73,120,0.39166668
G3600670002901,36,67,2901,44,117,161,0.27329192
G3600670003000,36,67,3000,142,48,190,0.7473684
G3600670003200,36,67,3200,33,8,41,0.80487806
G3600670003400,36,67,3400,23,63,86,0.26744187
G3600670003500,36,67,3500,155,39,194,0.79896909
G3600670003601,36,67,3601,115,197,312,0.36858973
G3600670003602,36,67,3602,40,135,175,0.22857143
G3600670003800,36,67,3800,109,106,215,0.50697672
G3600670003900,36,67,3900,294,160,454,0.64757711
G3600670004000,36,67,4000,80,137,217,0.36866361
G3600670004200,36,67,4200,239,135,374,0.63903743
G3600670004301,36,67,4301,40,29,69,0.57971013
G3600670004302,36,67,4302,8,11,19,0.42105263
G3600670004400,36,67,4400,0,34,34,0
G3600670004500,36,67,4500,0,153,153,0
G3600670004600,36,67,4600,79,231,310,0.25483871
G3600670004800,36,67,4800,30,58,88,0.34090909
G3600670004900,36,67,4900,101,70,171,0.59064329
G3600670005000,36,67,5000,59,208,267,0.22097379
G3600670005100,36,67,5100,179,132,311,0.57556272
G3600670005200,36,67,5200,112,120,232,0.48275861
G3600670005300,36,67,5300,125,105,230,0.54347825
G3600670005400,36,67,5400,182,168,350,0.51999998
G3600670005500,36,67,5500,105,146,251,0.41832671
G3600670005601,36,67,5601,12,112,124,0.096774191
G3600670005602,36,67,5602,0,3,3,0
G3600670005700,36,67,5700,43,170,213,0.20187794
G3600670005800,36,67,5800,150,147,297,0.50505048
G3600670005900,36,67,5900,62,124,186,0.33333334
G3600670006000,36,67,6000,81,268,349,0.2320917
G3600670006101,36,67,6101,119,252,371,0.32075471
G3600670006102,36,67,6102,60,36,96,0.625
G3600670006103,36,67,6103,18,195,213,0.084507041
G3600670010100,36,67,10100,22,323,345,0.063768119
G3600670010200,36,67,10200,53,415,468,0.11324786
G3600670010301,36,67,10301,60,521,581,0.10327023
G3600670010321,36,67,10321,22,338,360,0.061111111
G3600670010322,36,67,10322,26,504,530,0.049056605
G3600670010400,36,67,10400,27,486,513,0.052631579
G3600670010500,36,67,10500,52,198,250,0.208
G3600670010600,36,67,10600,6,242,248,0.024193548
G3600670010700,36,67,10700,10,152,162,0.061728396
G3600670010800,36,67,10800,55,296,351,0.15669516
G3600670010900,36,67,10900,24,167,191,0.12565444
G3600670011011,36,67,11011,0,260,260,0
G3600670011012,36,67,11012,16,252,268,0.059701491
G3600670011021,36,67,11021,2,381,383,0.005221932
G3600670011022,36,67,11022,82,253,335,0.24477611
G3600670011101,36,67,11101,74,542,616,0.12012987
G3600670011102,36,67,11102,106,334,440,0.24090908
G3600670011201,36,67,11201,73,308,381,0.19160105
G3600670011202,36,67,11202,23,522,545,0.042201836
G3600670011231,36,67,11231,63,426,489,0.12883435
G3600670011232,36,67,11232,104,379,483,0.21532091
G3600670011241,36,67,11241,10,288,298,0.033557046
G3600670011242,36,67,11242,107,748,855,0.1251462
G3600670011300,36,67,11300,0,252,252,0
G3600670011401,36,67,11401,142,551,693,0.20490621
G3600670011402,36,67,11402,9,343,352,0.025568182
G3600670011500,36,67,11500,43,594,637,0.067503922
G3600670011600,36,67,11600,17,554,571,0.02977233
G3600670011700,36,67,11700,21,244,265,0.079245284
G3600670011800,36,67,11800,52,477,529,0.098298676
G3600670011900,36,67,11900,0,366,366,0
G3600670012000,36,67,12000,97,491,588,0.16496599
G3600670012100,36,67,12100,21,442,463,0.045356371
G3600670012200,36,67,12200,9,124,133,0.067669176
G3600670012300,36,67,12300,54,281,335,0.16119403
G3600670012400,36,67,12400,10,392,402,0.024875622
G3600670012500,36,67,12500,10,367,377,0.026525199
G3600670012600,36,67,12600,0,569,569,0
G3600670012700,36,67,12700,14,117,131,0.10687023
G3600670012800,36,67,12800,6,179,185,0.032432433
G3600670012900,36,67,12900,76,167,243,0.31275719
G3600670013000,36,67,13000,42,238,280,0.15000001
G3600670013100,36,67,13100,20,361,381,0.052493438
G3600670013200,36,67,13200,0,254,254,0
G3600670013300,36,67,13300,14,155,169,0.082840234
G3600670013400,36,67,13400,12,449,461,0.026030369
G3600670013500,36,67,13500,46,390,436,0.10550459
G3600670013600,36,67,13600,0,333,333,0
G3600670013701,36,67,13701,76,317,393,0.19338423
G3600670013800,36,67,13800,0,140,140,0
G3600670013900,36,67,13900,52,349,401,0.12967581
G3600670014000,36,67,14000,78,370,448,0.17410715
G3600670014200,36,67,14200,89,219,308,0.28896105
G3600670014300,36,67,14300,51,325,376,0.1356383
G3600670014400,36,67,14400,8,220,228,0.03508772
G3600670014500,36,67,14500,36,285,321,0.11214953
G3600670014600,36,67,14600,79,311,390,0.20256411
G3600670014700,36,67,14700,13,724,737,0.017639078
G3600670014800,36,67,14800,22,299,321,0.068535827
G3600670014900,36,67,14900,4,171,175,0.022857143
G3600670015000,36,67,15000,27,478,505,0.053465348
G3600670015100,36,67,15100,31,619,650,0.047692306
G3600670015201,36,67,15201,0,236,236,0
G3600670015202,36,67,15202,0,583,583,0
G3600670015203,36,67,15203,30,364,394,0.076142132
G3600670015400,36,67,15400,41,492,533,0.07692308
G3600670015500,36,67,15500,23,192,215,0.10697675
G3600670015601,36,67,15601,92,266,358,0.25698325
G3600670015700,36,67,15700,46,693,739,0.062246278
G3600670015800,36,67,15800,29,490,519,0.055876687
G3600670016001,36,67,16001,0,306,306,0
G3600670016002,36,67,16002,10,378,388,0.025773196
G3600670016100,36,67,16100,0,276,276,0
G3600670016200,36,67,16200,25,174,199,0.12562814
G3600670016300,36,67,16300,0,693,693,0
G3600670016400,36,67,16400,11,402,413,0.026634382
G3600670016501,36,67,16501,12,203,215,0.055813953
G3600670016502,36,67,16502,30,438,468,0.064102568
G3600670016600,36,67,16600,10,445,455,0.021978023
G3600670016700,36,67,16700,0,263,263,0
G3600670016801,36,67,16801,12,143,155,0.077419356
G3600670016802,36,67,16802,51,247,298,0.17114094
G3600670016901,36,67,16901,23,289,312,0.073717952
G3600670016902,36,67,16902,31,215,246,0.12601626
G3600670940000,36,67,940000,0,0,0,
G3600690050101,36,69,50101,0,370,370,0
G3600690050102,36,69,50102,15,1235,1250,0.012
G3600690050201,36,69,50201,176,592,768,0.22916667
G3600690050202,36,69,50202,42,857,899,0.046718575
G3600690050301,36,69,50301,9,439,448,0.020089285
G3600690050302,36,69,50302,71,437,508,0.13976377
G3600690050400,36,69,50400,77,643,720,0.10694444
G3600690050500,36,69,50500,75,573,648,0.11574074
G3600690050601,36,69,50601,45,474,519,0.0867052
G3600690050602,36,69,50602,63,330,393,0.16030534
G3600690050800,36,69,50800,69,271,340,0.20294118
G3600690050900,36,69,50900,0,195,195,0
G3600690051000,36,69,51000,46,116,162,0.28395063
G3600690051100,36,69,51100,47,151,198,0.23737374
G3600690051200,36,69,51200,33,314,347,0.095100865
G3600690051300,36,69,51300,54,249,303,0.17821783
G3600690051400,36,69,51400,0,211,211,0
G3600690051500,36,69,51500,22,166,188,0.11702128
G3600690051600,36,69,51600,55,223,278,0.19784173
G3600690051700,36,69,51700,99,134,233,0.42489269
G3600690051800,36,69,51800,85,209,294,0.28911564
G3600690051900,36,69,51900,97,125,222,0.43693694
G3600690052000,36,69,52000,27,329,356,0.075842693
G3600690052100,36,69,52100,36,272,308,0.11688311
G3600690052200,36,69,52200,40,139,179,0.22346368
G3600710000100,36,71,100,108,178,286,0.37762237
G3600710000200,36,71,200,87,201,288,0.30208334
G3600710000300,36,71,300,329,563,892,0.36883408
G3600710000400,36,71,400,251,286,537,0.46741155
G3600710000501,36,71,501,241,324,565,0.42654866
G3600710000502,36,71,502,228,366,594,0.38383839
G3600710000600,36,71,600,201,242,443,0.45372459
G3600710001100,36,71,1100,108,267,375,0.28799999
G3600710001200,36,71,1200,119,187,306,0.3888889
G3600710001300,36,71,1300,0,395,395,0
G3600710001500,36,71,1500,229,414,643,0.35614309
G3600710001600,36,71,1600,135,419,554,0.24368231
G3600710002100,36,71,2100,51,247,298,0.17114094
G3600710002200,36,71,2200,84,177,261,0.32183909
G3600710002300,36,71,2300,17,157,174,0.097701147
G3600710010101,36,71,10101,7,546,553,0.012658228
G3600710010102,36,71,10102,55,421,476,0.11554622
G3600710010200,36,71,10200,3,330,333,0.009009009
G3600710010300,36,71,10300,0,353,353,0
G3600710010400,36,71,10400,16,400,416,0.03846154
G3600710010500,36,71,10500,129,817,946,0.13636364
G3600710010600,36,71,10600,37,711,748,0.049465239
G3600710010700,36,71,10700,57,695,752,0.075797871
G3600710010801,36,71,10801,45,288,333,0.13513513
G3600710010802,36,71,10802,12,451,463,0.025917927
G3600710010901,36,71,10901,7,297,304,0.023026315
G3600710010902,36,71,10902,93,571,664,0.14006025
G3600710011000,36,71,11000,102,500,602,0.16943522
G3600710011101,36,71,11101,0,309,309,0
G3600710011102,36,71,11102,7,399,406,0.017241379
G3600710011200,36,71,11200,23,454,477,0.04821803
G3600710011300,36,71,11300,0,561,561,0
G3600710011400,36,71,11400,51,362,413,0.12348668
G3600710011500,36,71,11500,80,432,512,0.15625
G3600710011601,36,71,11601,20,300,320,0.0625
G3600710011602,36,71,11602,65,255,320,0.203125
G3600710011701,36,71,11701,91,546,637,0.14285715
G3600710011702,36,71,11702,69,620,689,0.10014514
G3600710011801,36,71,11801,36,481,517,0.069632493
G3600710011802,36,71,11802,14,265,279,0.050179213
G3600710011900,36,71,11900,27,465,492,0.054878049
G3600710012100,36,71,12100,0,297,297,0
G3600710012200,36,71,12200,24,357,381,0.062992126
G3600710012300,36,71,12300,64,570,634,0.10094637
G3600710012601,36,71,12601,0,270,270,0
G3600710012602,36,71,12602,78,223,301,0.2591362
G3600710012700,36,71,12700,10,288,298,0.033557046
G3600710012800,36,71,12800,8,419,427,0.018735362
G3600710012900,36,71,12900,5,336,341,0.014662757
G3600710013000,36,71,13000,26,530,556,0.046762589
G3600710013100,36,71,13100,0,584,584,0
G3600710013201,36,71,13201,68,493,561,0.12121212
G3600710013202,36,71,13202,39,162,201,0.19402985
G3600710013300,36,71,13300,90,703,793,0.11349306
G3600710013400,36,71,13400,10,298,308,0.032467533
G3600710013500,36,71,13500,53,607,660,0.080303028
G3600710013600,36,71,13600,20,493,513,0.038986355
G3600710013700,36,71,13700,23,194,217,0.10599078
G3600710013800,36,71,13800,66,142,208,0.31730768
G3600710013900,36,71,13900,17,518,535,0.031775702
G3600710014101,36,71,14101,6,316,322,0.018633541
G3600710014102,36,71,14102,52,595,647,0.08037094
G3600710014201,36,71,14201,55,412,467,0.11777302
G3600710014202,36,71,14202,22,625,647,0.03400309
G3600710014301,36,71,14301,25,504,529,0.047258981
G3600710014302,36,71,14302,26,580,606,0.042904291
G3600710014400,36,71,14400,35,425,460,0.076086953
G3600710014501,36,71,14501,18,459,477,0.03773585
G3600710014502,36,71,14502,15,530,545,0.027522936
G3600710014600,36,71,14600,13,640,653,0.019908117
G3600710014700,36,71,14700,40,423,463,0.086393088
G3600710014800,36,71,14800,11,509,520,0.021153847
G3600710014900,36,71,14900,5,385,390,0.012820513
G3600710015003,36,71,15003,100,231,331,0.30211481
G3600710015004,36,71,15004,264,196,460,0.57391304
G3600710015005,36,71,15005,32,393,425,0.075294115
G3600710015006,36,71,15006,118,287,405,0.29135802
G3600710015100,36,71,15100,190,376,566,0.33568904
G3600710015200,36,71,15200,18,1235,1253,0.014365523
G3600730040200,36,73,40200,18,294,312,0.057692308
G3600730040300,36,73,40300,76,150,226,0.33628318
G3600730040400,36,73,40400,115,270,385,0.29870129
G3600730040500,36,73,40500,104,175,279,0.37275985
G3600730040600,36,73,40600,39,483,522,0.074712642
G3600730040700,36,73,40700,171,226,397,0.43073049
G3600730040801,36,73,40801,90,340,430,0.20930232
G3600730040802,36,73,40802,66,284,350,0.18857142
G3600730401200,36,73,401200,49,364,413,0.11864407
G3600730401300,36,73,401300,86,358,444,0.1936937
G3600730990000,36,73,990000,0,0,0,
G3600750020100,36,75,20100,51,313,364,0.1401099
G3600750020200,36,75,20200,86,277,363,0.2369146
G3600750020301,36,75,20301,42,167,209,0.20095694
G3600750020302,36,75,20302,22,271,293,0.075085327
G3600750020400,36,75,20400,137,432,569,0.24077329
G3600750020500,36,75,20500,164,524,688,0.23837209
G3600750020600,36,75,20600,95,511,606,0.15676567
G3600750020701,36,75,20701,105,292,397,0.26448363
G3600750020702,36,75,20702,46,416,462,0.0995671
G3600750020703,36,75,20703,84,501,585,0.14358975
G3600750020800,36,75,20800,69,311,380,0.18157895
G3600750020901,36,75,20901,28,192,220,0.12727273
G3600750020902,36,75,20902,44,381,425,0.10352941
G3600750021000,36,75,21000,95,537,632,0.15031646
G3600750021101,36,75,21101,233,283,516,0.45155039
G3600750021102,36,75,21102,123,97,220,0.55909091
G3600750021103,36,75,21103,40,251,291,0.13745704
G3600750021104,36,75,21104,27,224,251,0.10756972
G3600750021200,36,75,21200,193,438,631,0.30586371
G3600750021300,36,75,21300,198,355,553,0.35804701
G3600750021401,36,75,21401,30,319,349,0.085959889
G3600750021402,36,75,21402,24,122,146,0.16438356
G3600750021501,36,75,21501,36,231,267,0.13483146
G3600750021502,36,75,21502,51,724,775,0.065806448
G3600750021601,36,75,21601,36,152,188,0.19148937
G3600750021602,36,75,21602,63,166,229,0.27510917
G3600750021603,36,75,21603,24,300,324,0.074074075
G3600750021604,36,75,21604,230,206,436,0.52752292
G3600750021605,36,75,21605,34,245,279,0.1218638
G3600750990000,36,75,990000,0,0,0,
G3600770590100,36,77,590100,36,405,441,0.081632651
G3600770590201,36,77,590201,28,160,188,0.14893617
G3600770590202,36,77,590202,34,255,289,0.11764706
G3600770590300,36,77,590300,73,340,413,0.17675544
G3600770590400,36,77,590400,62,464,526,0.11787073
G3600770590500,36,77,590500,45,267,312,0.14423077
G3600770590600,36,77,590600,13,189,202,0.064356439
G3600770590700,36,77,590700,116,324,440,0.26363635
G3600770590800,36,77,590800,110,489,599,0.18363939
G3600770590900,36,77,590900,21,126,147,0.14285715
G3600770591000,36,77,591000,20,173,193,0.10362694
G3600770591100,36,77,591100,53,167,220,0.24090908
G3600770591200,36,77,591200,8,77,85,0.094117649
G3600770591300,36,77,591300,0,3,3,0
G3600770591400,36,77,591400,182,346,528,0.34469697
G3600770591500,36,77,591500,95,282,377,0.25198939
G3600770591600,36,77,591600,44,457,501,0.087824352
G3600790010100,36,79,10100,24,406,430,0.055813953
G3600790010200,36,79,10200,42,755,797,0.052697618
G3600790010300,36,79,10300,103,453,556,0.1852518
G3600790010400,36,79,10400,8,255,263,0.030418251
G3600790010500,36,79,10500,48,479,527,0.091081597
G3600790010600,36,79,10600,27,410,437,0.061784897
G3600790010700,36,79,10700,49,231,280,0.175
G3600790010800,36,79,10800,0,220,220,0
G3600790010900,36,79,10900,118,768,886,0.13318284
G3600790011000,36,79,11000,68,398,466,0.14592275
G3600790011100,36,79,11100,0,689,689,0
G3600790011200,36,79,11200,18,703,721,0.024965325
G3600790011300,36,79,11300,71,395,466,0.15236051
G3600790011400,36,79,11400,0,552,552,0
G3600790011500,36,79,11500,55,634,689,0.079825833
G3600790011600,36,79,11600,0,434,434,0
G3600790011700,36,79,11700,27,474,501,0.053892214
G3600790011800,36,79,11800,64,597,661,0.096822992
G3600790011900,36,79,11900,10,606,616,0.016233766
G3600810000100,36,81,100,18,169,187,0.096256681
G3600810000200,36,81,200,74,266,340,0.21764706
G3600810000400,36,81,400,161,375,536,0.30037314
G3600810000600,36,81,600,113,378,491,0.23014256
G3600810000700,36,81,700,0,266,266,0
G3600810000800,36,81,800,122,294,416,0.29326922
G3600810001000,36,81,1000,44,383,427,0.10304449
G3600810001200,36,81,1200,96,354,450,0.21333334
G3600810001400,36,81,1400,4,339,343,0.011661808
G3600810001600,36,81,1600,57,219,276,0.20652173
G3600810001800,36,81,1800,124,238,362,0.34254143
G3600810001900,36,81,1900,0,42,42,0
G3600810002000,36,81,2000,51,157,208,0.2451923
G3600810002200,36,81,2200,67,185,252,0.26587301
G3600810002400,36,81,2400,99,168,267,0.37078652
G3600810002500,36,81,2500,328,276,604,0.54304636
G3600810002600,36,81,2600,69,233,302,0.22847682
G3600810002800,36,81,2800,40,253,293,0.13651878
G3600810003000,36,81,3000,46,97,143,0.32167831
G3600810003100,36,81,3100,27,77,104,0.25961539
G3600810003200,36,81,3200,52,163,215,0.24186046
G3600810003300,36,81,3300,68,112,180,0.37777779
G3600810003400,36,81,3400,92,210,302,0.30463576
G3600810003600,36,81,3600,70,395,465,0.15053764
G3600810003700,36,81,3700,0,0,0,
G3600810003800,36,81,3800,72,191,263,0.27376425
G3600810003900,36,81,3900,51,76,127,0.40157479
G3600810004001,36,81,4001,58,198,256,0.2265625
G3600810004002,36,81,4002,74,123,197,0.37563452
G3600810004200,36,81,4200,144,371,515,0.27961165
G3600810004300,36,81,4300,142,143,285,0.49824563
G3600810004401,36,81,4401,166,174,340,0.48823529
G3600810004500,36,81,4500,44,200,244,0.18032786
G3600810004700,36,81,4700,179,342,521,0.34357005
G3600810005000,36,81,5000,0,0,0,
G3600810005100,36,81,5100,162,131,293,0.55290103
G3600810005200,36,81,5200,56,204,260,0.21538462
G3600810005300,36,81,5300,32,84,116,0.27586207
G3600810005400,36,81,5400,236,379,615,0.38373983
G3600810005500,36,81,5500,30,60,90,0.33333334
G3600810005700,36,81,5700,187,157,344,0.54360467
G3600810005800,36,81,5800,85,483,568,0.14964789
G3600810005900,36,81,5900,50,158,208,0.24038461
G3600810006100,36,81,6100,50,133,183,0.27322406
G3600810006201,36,81,6201,26,238,264,0.098484851
G3600810006202,36,81,6202,99,632,731,0.13543092
G3600810006300,36,81,6300,164,204,368,0.44565219
G3600810006501,36,81,6501,29,100,129,0.2248062
G3600810006502,36,81,6502,83,171,254,0.32677165
G3600810006900,36,81,6900,22,196,218,0.10091743
G3600810007100,36,81,7100,61,149,210,0.2904762
G3600810007300,36,81,7300,0,150,150,0
G3600810007500,36,81,7500,15,156,171,0.087719299
G3600810007700,36,81,7700,0,46,46,0
G3600810007900,36,81,7900,57,235,292,0.19520548
G3600810008100,36,81,8100,30,80,110,0.27272728
G3600810008300,36,81,8300,58,284,342,0.16959064
G3600810008500,36,81,8500,52,107,159,0.32704404
G3600810008600,36,81,8600,57,204,261,0.21839081
G3600810008700,36,81,8700,220,295,515,0.42718446
G3600810008800,36,81,8800,22,378,400,0.055
G3600810009100,36,81,9100,48,241,289,0.16608997
G3600810009400,36,81,9400,76,279,355,0.21408451
G3600810009500,36,81,9500,44,175,219,0.20091324
G3600810009600,36,81,9600,102,332,434,0.23502304
G3600810009700,36,81,9700,9,193,202,0.044554457
G3600810009800,36,81,9800,106,243,349,0.30372491
G3600810009900,36,81,9900,0,0,0,
G3600810010000,36,81,10000,90,253,343,0.26239067
G3600810010100,36,81,10100,16,145,161,0.099378884
G3600810010200,36,81,10200,73,263,336,0.21726191
G3600810010300,36,81,10300,48,185,233,0.20600858
G3600810010400,36,81,10400,132,186,318,0.41509435
G3600810010500,36,81,10500,134,254,388,0.34536082
G3600810010600,36,81,10600,96,261,357,0.26890758
G3600810010701,36,81,10701,0,0,0,
G3600810010800,36,81,10800,82,333,415,0.19759037
G3600810011000,36,81,11000,151,334,485,0.31134021
G3600810011100,36,81,11100,15,205,220,0.06818182
G3600810011200,36,81,11200,52,154,206,0.25242719
G3600810011300,36,81,11300,0,299,299,0
G3600810011400,36,81,11400,61,96,157,0.38853502
G3600810011500,36,81,11500,31,28,59,0.52542371
G3600810011600,36,81,11600,29,168,197,0.14720812
G3600810011700,36,81,11700,22,81,103,0.21359223
G3600810011800,36,81,11800,76,277,353,0.21529745
G3600810011900,36,81,11900,35,59,94,0.37234041
G3600810012000,36,81,12000,121,173,294,0.41156462
G3600810012100,36,81,12100,32,90,122,0.26229507
G3600810012200,36,81,12200,83,246,329,0.25227964
G3600810012301,36,81,12301,0,167,167,0
G3600810012400,36,81,12400,101,203,304,0.33223686
G3600810012500,36,81,12500,0,79,79,0
G3600810012601,36,81,12601,81,289,370,0.21891892
G3600810012602,36,81,12602,66,217,283,0.23321554
G3600810012800,36,81,12800,33,193,226,0.1460177
G3600810013000,36,81,13000,0,192,192,0
G3600810013200,36,81,13200,60,169,229,0.26200873
G3600810013400,36,81,13400,39,333,372,0.10483871
G3600810013500,36,81,13500,9,162,171,0.052631579
G3600810013600,36,81,13600,8,134,142,0.056338027
G3600810013700,36,81,13700,25,118,143,0.17482518
G3600810013800,36,81,13800,90,262,352,0.25568181
G3600810014000,36,81,14000,20,301,321,0.062305298
G3600810014100,36,81,14100,0,71,71,0
G3600810014201,36,81,14201,134,344,478,0.28033474
G3600810014202,36,81,14202,70,177,247,0.2834008
G3600810014300,36,81,14300,78,223,301,0.2591362
G3600810014400,36,81,14400,76,147,223,0.34080717
G3600810014500,36,81,14500,60,152,212,0.28301886
G3600810014700,36,81,14700,8,174,182,0.043956045
G3600810014800,36,81,14800,107,191,298,0.35906041
G3600810014900,36,81,14900,20,128,148,0.13513513
G3600810015000,36,81,15000,29,225,254,0.11417323
G3600810015100,36,81,15100,64,41,105,0.60952383
G3600810015200,36,81,15200,54,129,183,0.29508197
G3600810015300,36,81,15300,15,83,98,0.15306123
G3600810015400,36,81,15400,111,161,272,0.40808824
G3600810015500,36,81,15500,32,66,98,0.32653061
G3600810015600,36,81,15600,62,267,329,0.18844984
G3600810015700,36,81,15700,46,45,91,0.50549453
G3600810015801,36,81,15801,54,363,417,0.1294964
G3600810015802,36,81,15802,91,200,291,0.31271479
G3600810015900,36,81,15900,202,75,277,0.72924185
G3600810016100,36,81,16100,61,141,202,0.3019802
G3600810016300,36,81,16300,80,154,234,0.34188035
G3600810016400,36,81,16400,50,284,334,0.1497006
G3600810016600,36,81,16600,24,394,418,0.057416268
G3600810016800,36,81,16800,28,281,309,0.090614885
G3600810016900,36,81,16900,47,432,479,0.098121084
G3600810017000,36,81,17000,81,173,254,0.31889763
G3600810017100,36,81,17100,0,0,0,
G3600810017200,36,81,17200,24,180,204,0.11764706
G3600810017400,36,81,17400,63,193,256,0.24609375
G3600810017600,36,81,17600,37,283,320,0.115625
G3600810017800,36,81,17800,70,148,218,0.32110092
G3600810017900,36,81,17900,10,72,82,0.12195122
G3600810018000,36,81,18000,15,139,154,0.097402595
G3600810018101,36,81,18101,49,332,381,0.12860893
G3600810018102,36,81,18102,69,130,199,0.34673366
G3600810018200,36,81,18200,29,165,194,0.14948453
G3600810018300,36,81,18300,216,304,520,0.41538462
G3600810018401,36,81,18401,5,210,215,0.023255814
G3600810018402,36,81,18402,82,190,272,0.30147058
G3600810018501,36,81,18501,60,189,249,0.24096386
G3600810018502,36,81,18502,104,161,265,0.39245284
G3600810018600,36,81,18600,37,159,196,0.18877551
G3600810018700,36,81,18700,18,234,252,0.071428575
G3600810018800,36,81,18800,7,123,130,0.053846154
G3600810018900,36,81,18900,59,259,318,0.1855346
G3600810019000,36,81,19000,28,181,209,0.13397129
G3600810019200,36,81,19200,0,177,177,0
G3600810019400,36,81,19400,10,249,259,0.038610037
G3600810019600,36,81,19600,45,282,327,0.13761468
G3600810019800,36,81,19800,206,210,416,0.49519232
G3600810019900,36,81,19900,0,59,59,0
G3600810020200,36,81,20200,75,136,211,0.35545024
G3600810020400,36,81,20400,101,181,282,0.35815603
G3600810020500,36,81,20500,13,51,64,0.203125
G3600810020600,36,81,20600,18,171,189,0.095238097
G3600810020800,36,81,20800,55,262,317,0.17350158
G3600810021200,36,81,21200,39,107,146,0.26712328
G3600810021400,36,81,21400,147,425,572,0.256993
G3600810021600,36,81,21600,85,341,426,0.19953051
G3600810021900,36,81,21900,0,0,0,
G3600810022001,36,81,22001,71,319,390,0.18205129
G3600810022002,36,81,22002,29,465,494,0.058704454
G3600810022900,36,81,22900,0,0,0,
G3600810023000,36,81,23000,6,213,219,0.02739726
G3600810023200,36,81,23200,56,333,389,0.14395887
G3600810023500,36,81,23500,394,498,892,0.44170403
G3600810023600,36,81,23600,70,178,248,0.28225806
G3600810023800,36,81,23800,243,312,555,0.43783784
G3600810024000,36,81,24000,144,286,430,0.33488372
G3600810024300,36,81,24300,50,431,481,0.10395011
G3600810024500,36,81,24500,147,408,555,0.26486486
G3600810024600,36,81,24600,0,0,0,
G3600810024700,36,81,24700,0,120,120,0
G3600810024900,36,81,24900,73,254,327,0.2232416
G3600810025100,36,81,25100,0,635,635,0
G3600810025301,36,81,25301,8,159,167,0.047904193
G3600810025302,36,81,25302,63,176,239,0.26359832
G3600810025400,36,81,25400,238,733,971,0.24510814
G3600810025500,36,81,25500,12,70,82,0.14634146
G3600810025700,36,81,25700,0,93,93,0
G3600810025800,36,81,25800,40,201,241,0.16597511
G3600810025900,36,81,25900,26,250,276,0.094202898
G3600810026000,36,81,26000,151,145,296,0.51013511
G3600810026100,36,81,26100,87,512,599,0.14524207
G3600810026200,36,81,26200,37,149,186,0.19892474
G3600810026300,36,81,26300,25,539,564,0.044326242
G3600810026400,36,81,26400,15,252,267,0.056179777
G3600810026500,36,81,26500,38,396,434,0.087557606
G3600810026600,36,81,26600,34,115,149,0.22818792
G3600810026700,36,81,26700,71,379,450,0.15777777
G3600810026901,36,81,26901,135,289,424,0.31839624
G3600810026902,36,81,26902,46,217,263,0.17490494
G3600810027000,36,81,27000,53,166,219,0.24200913
G3600810027100,36,81,27100,292,579,871,0.33524683
G3600810027200,36,81,27200,61,209,270,0.22592592
G3600810027300,36,81,27300,242,683,925,0.26162162
G3600810027400,36,81,27400,0,167,167,0
G3600810027500,36,81,27500,141,475,616,0.22889611
G3600810027600,36,81,27600,4,192,196,0.020408163
G3600810027700,36,81,27700,123,595,718,0.17130919
G3600810027800,36,81,27800,61,152,213,0.28638497
G3600810027900,36,81,27900,14,447,461,0.030368764
G3600810028000,36,81,28000,0,190,190,0
G3600810028100,36,81,28100,0,294,294,0
G3600810028200,36,81,28200,0,205,205,0
G3600810028300,36,81,28300,154,274,428,0.35981309
G3600810028400,36,81,28400,145,410,555,0.26126125
G3600810028500,36,81,28500,154,289,443,0.34762979
G3600810028700,36,81,28700,141,353,494,0.2854251
G3600810028800,36,81,28800,75,494,569,0.13181019
G3600810028900,36,81,28900,68,406,474,0.14345992
G3600810029100,36,81,29100,87,415,502,0.17330678
G3600810029300,36,81,29300,6,98,104,0.057692308
G3600810029400,36,81,29400,39,595,634,0.061514195
G3600810029500,36,81,29500,23,280,303,0.075907588
G3600810029700,36,81,29700,85,156,241,0.3526971
G3600810029900,36,81,29900,0,0,0,
G3600810030600,36,81,30600,65,378,443,0.14672686
G3600810030902,36,81,30902,283,712,995,0.2844221
G3600810030903,36,81,30903,226,559,785,0.28789809
G3600810030904,36,81,30904,126,223,349,0.36103153
G3600810031700,36,81,31700,21,365,386,0.054404143
G3600810032000,36,81,32000,10,396,406,0.024630541
G3600810032700,36,81,32700,98,245,343,0.2857143
G3600810032800,36,81,32800,38,255,293,0.12969284
G3600810032900,36,81,32900,85,226,311,0.27331188
G3600810033000,36,81,33000,145,601,746,0.19436997
G3600810033100,36,81,33100,0,0,0,
G3600810033401,36,81,33401,71,330,401,0.17705736
G3600810033402,36,81,33402,189,1079,1268,0.14905363
G3600810033700,36,81,33700,53,253,306,0.17320262
G3600810033900,36,81,33900,0,286,286,0
G3600810034700,36,81,34700,58,352,410,0.14146341
G3600810035100,36,81,35100,146,319,465,0.31397849
G3600810035200,36,81,35200,16,275,291,0.054982819
G3600810035300,36,81,35300,116,159,275,0.42181817
G3600810035700,36,81,35700,51,285,336,0.15178572
G3600810035800,36,81,35800,27,422,449,0.060133629
G3600810036100,36,81,36100,105,231,336,0.3125
G3600810036300,36,81,36300,92,163,255,0.36078432
G3600810036500,36,81,36500,101,268,369,0.27371272
G3600810036600,36,81,36600,17,260,277,0.061371841
G3600810036700,36,81,36700,56,185,241,0.23236515
G3600810036800,36,81,36800,12,189,201,0.059701491
G3600810037100,36,81,37100,61,99,160,0.38124999
G3600810037300,36,81,37300,80,201,281,0.2846975
G3600810037500,36,81,37500,133,275,408,0.3259804
G3600810037600,36,81,37600,44,540,584,0.075342469
G3600810037700,36,81,37700,39,322,361,0.10803324
G3600810037900,36,81,37900,88,527,615,0.14308943
G3600810038100,36,81,38100,267,434,701,0.38088444
G3600810038301,36,81,38301,0,0,0,
G3600810038302,36,81,38302,0,0,0,
G3600810038400,36,81,38400,13,240,253,0.051383398
G3600810039400,36,81,39400,51,241,292,0.17465754
G3600810039800,36,81,39800,8,147,155,0.051612902
G3600810039900,36,81,39900,188,388,576,0.3263889
G3600810040000,36,81,40000,15,144,159,0.094339624
G3600810040100,36,81,40100,229,499,728,0.31456044
G3600810040200,36,81,40200,0,135,135,0
G3600810040300,36,81,40300,213,587,800,0.26625001
G3600810040400,36,81,40400,73,327,400,0.1825
G3600810040500,36,81,40500,124,247,371,0.33423179
G3600810040700,36,81,40700,231,516,747,0.30923694
G3600810040900,36,81,40900,173,348,521,0.33205375
G3600810041100,36,81,41100,211,260,471,0.44798303
G3600810041300,36,81,41300,158,342,500,0.31600001
G3600810041400,36,81,41400,34,378,412,0.08252427
G3600810041500,36,81,41500,123,376,499,0.24649298
G3600810042400,36,81,42400,44,150,194,0.22680412
G3600810042600,36,81,42600,0,0,0,
G3600810042700,36,81,42700,216,336,552,0.39130434
G3600810043200,36,81,43200,0,149,149,0
G3600810043400,36,81,43400,0,185,185,0
G3600810043701,36,81,43701,122,238,360,0.33888888
G3600810043702,36,81,43702,187,462,649,0.28813559
G3600810043900,36,81,43900,334,283,617,0.54132903
G3600810044000,36,81,44000,104,357,461,0.22559653
G3600810044301,36,81,44301,209,100,309,0.67637539
G3600810044302,36,81,44302,135,303,438,0.30821916
G3600810044400,36,81,44400,102,183,285,0.35789475
G3600810044601,36,81,44601,18,230,248,0.072580643
G3600810044602,36,81,44602,200,264,464,0.43103448
G3600810044800,36,81,44800,158,181,339,0.4660767
G3600810045000,36,81,45000,10,129,139,0.071942449
G3600810045200,36,81,45200,12,39,51,0.23529412
G3600810045400,36,81,45400,108,304,412,0.26213592
G3600810045500,36,81,45500,231,947,1178,0.19609508
G3600810045600,36,81,45600,28,82,110,0.25454545
G3600810045700,36,81,45700,0,144,144,0
G3600810045800,36,81,45800,74,156,230,0.32173914
G3600810045900,36,81,45900,100,249,349,0.28653294
G3600810046000,36,81,46000,211,399,610,0.34590164
G3600810046100,36,81,46100,75,171,246,0.30487806
G3600810046200,36,81,46200,216,678,894,0.24161074
G3600810046300,36,81,46300,30,355,385,0.077922076
G3600810046400,36,81,46400,0,71,71,0
G3600810046500,36,81,46500,29,188,217,0.13364056
G3600810046600,36,81,46600,90,220,310,0.29032257
G3600810046700,36,81,46700,320,427,747,0.42838019
G3600810046800,36,81,46800,107,259,366,0.29234973
G3600810046900,36,81,46900,298,474,772,0.38601035
G3600810047000,36,81,47000,93,233,326,0.28527609
G3600810047100,36,81,47100,156,283,439,0.35535309
G3600810047200,36,81,47200,0,116,116,0
G3600810047300,36,81,47300,82,189,271,0.30258304
G3600810047500,36,81,47500,167,317,484,0.34504133
G3600810047600,36,81,47600,14,142,156,0.089743592
G3600810047800,36,81,47800,17,366,383,0.044386424
G3600810047900,36,81,47900,176,416,592,0.2972973
G3600810048000,36,81,48000,31,213,244,0.12704918
G3600810048100,36,81,48100,40,457,497,0.0804829
G3600810048200,36,81,48200,16,142,158,0.10126583
G3600810048300,36,81,48300,196,266,462,0.42424244
G3600810048400,36,81,48400,48,431,479,0.10020877
G3600810048500,36,81,48500,34,279,313,0.1086262
G3600810048900,36,81,48900,10,133,143,0.069930069
G3600810049200,36,81,49200,58,316,374,0.15508021
G3600810049301,36,81,49301,7,198,205,0.034146342
G3600810049302,36,81,49302,12,178,190,0.063157894
G3600810049500,36,81,49500,11,115,126,0.08730159
G3600810049600,36,81,49600,63,215,278,0.22661871
G3600810049700,36,81,49700,18,277,295,0.061016951
G3600810049900,36,81,49900,89,359,448,0.19866072
G3600810050000,36,81,50000,108,237,345,0.31304348
G3600810050201,36,81,50201,3,135,138,0.021739131
G3600810050202,36,81,50202,0,73,73,0
G3600810050400,36,81,50400,24,142,166,0.14457831
G3600810050500,36,81,50500,35,71,106,0.33018869
G3600810050600,36,81,50600,0,135,135,0
G3600810050700,36,81,50700,0,302,302,0
G3600810050800,36,81,50800,18,221,239,0.075313807
G3600810051000,36,81,51000,12,172,184,0.065217391
G3600810051100,36,81,51100,4,164,168,0.023809524
G3600810051200,36,81,51200,29,283,312,0.09294872
G3600810051300,36,81,51300,10,198,208,0.048076924
G3600810051500,36,81,51500,39,147,186,0.20967741
G3600810051600,36,81,51600,33,100,133,0.24812031
G3600810051700,36,81,51700,18,132,150,0.12
G3600810051800,36,81,51800,21,259,280,0.075000003
G3600810052000,36,81,52000,0,155,155,0
G3600810052100,36,81,52100,49,120,169,0.28994083
G3600810052200,36,81,52200,10,212,222,0.045045044
G3600810052400,36,81,52400,35,127,162,0.21604939
G3600810052500,36,81,52500,44,104,148,0.2972973
G3600810052600,36,81,52600,63,106,169,0.37278107
G3600810052800,36,81,52800,11,107,118,0.093220338
G3600810053000,36,81,53000,35,211,246,0.14227642
G3600810053100,36,81,53100,30,167,197,0.15228426
G3600810053200,36,81,53200,16,134,150,0.10666667
G3600810053401,36,81,53401,14,171,185,0.075675674
G3600810053500,36,81,53500,45,146,191,0.2356021
G3600810053601,36,81,53601,34,152,186,0.1827957
G3600810053800,36,81,53800,6,175,181,0.033149172
G3600810053900,36,81,53900,91,322,413,0.22033899
G3600810054000,36,81,54000,77,351,428,0.17990655
G3600810054200,36,81,54200,229,506,735,0.31156462
G3600810054500,36,81,54500,134,316,450,0.29777777
G3600810054700,36,81,54700,198,322,520,0.38076922
G3600810054800,36,81,54800,20,192,212,0.094339624
G3600810054900,36,81,54900,253,315,568,0.44542253
G3600810055100,36,81,55100,119,377,496,0.23991935
G3600810055200,36,81,55200,39,177,216,0.18055555
G3600810055300,36,81,55300,150,141,291,0.51546389
G3600810055400,36,81,55400,38,136,174,0.21839081
G3600810055500,36,81,55500,37,170,207,0.17874396
G3600810055600,36,81,55600,19,205,224,0.084821425
G3600810055700,36,81,55700,121,266,387,0.3126615
G3600810055800,36,81,55800,0,101,101,0
G3600810055900,36,81,55900,49,121,170,0.28823531
G3600810056000,36,81,56000,64,158,222,0.2882883
G3600810056100,36,81,56100,0,22,22,0
G3600810056200,36,81,56200,19,100,119,0.15966387
G3600810056400,36,81,56400,8,147,155,0.051612902
G3600810056500,36,81,56500,81,132,213,0.38028169
G3600810056600,36,81,56600,15,171,186,0.080645159
G3600810056700,36,81,56700,38,359,397,0.095717885
G3600810056800,36,81,56800,9,423,432,0.020833334
G3600810057700,36,81,57700,52,222,274,0.18978103
G3600810057900,36,81,57900,12,157,169,0.071005918
G3600810058000,36,81,58000,7,259,266,0.02631579
G3600810058100,36,81,58100,81,191,272,0.2977941
G3600810058200,36,81,58200,173,292,465,0.37204301
G3600810058300,36,81,58300,0,249,249,0
G3600810058500,36,81,58500,73,424,497,0.14688128
G3600810058700,36,81,58700,69,288,357,0.19327731
G3600810058900,36,81,58900,114,294,408,0.27941176
G3600810059000,36,81,59000,31,82,113,0.27433628
G3600810059100,36,81,59100,140,569,709,0.19746122
G3600810059200,36,81,59200,0,70,70,0
G3600810059300,36,81,59300,37,282,319,0.11598746
G3600810059400,36,81,59400,6,117,123,0.048780486
G3600810059500,36,81,59500,72,270,342,0.21052632
G3600810059600,36,81,59600,0,147,147,0
G3600810059800,36,81,59800,0,195,195,0
G3600810059900,36,81,59900,19,97,116,0.1637931
G3600810060000,36,81,60000,7,113,120,0.058333334
G3600810060100,36,81,60100,23,144,167,0.13772455
G3600810060300,36,81,60300,28,163,191,0.14659686
G3600810060600,36,81,60600,4,137,141,0.028368793
G3600810060701,36,81,60701,0,0,0,
G3600810060800,36,81,60800,0,169,169,0
G3600810061000,36,81,61000,0,143,143,0
G3600810061200,36,81,61200,12,131,143,0.083916083
G3600810061301,36,81,61301,146,440,586,0.24914676
G3600810061302,36,81,61302,0,3,3,0
G3600810061400,36,81,61400,0,92,92,0
G3600810061601,36,81,61601,7,155,162,0.043209877
G3600810061602,36,81,61602,12,68,80,0.15000001
G3600810061800,36,81,61800,0,180,180,0
G3600810061900,36,81,61900,83,183,266,0.31203008
G3600810062000,36,81,62000,7,117,124,0.056451611
G3600810062100,36,81,62100,114,186,300,0.38
G3600810062200,36,81,62200,0,106,106,0
G3600810062300,36,81,62300,52,155,207,0.25120774
G3600810062400,36,81,62400,0,0,0,
G3600810062500,36,81,62500,5,159,164,0.030487806
G3600810062600,36,81,62600,14,317,331,0.042296074
G3600810062700,36,81,62700,19,362,381,0.049868766
G3600810062900,36,81,62900,34,265,299,0.11371238
G3600810063000,36,81,63000,0,147,147,0
G3600810063200,36,81,63200,16,218,234,0.068376072
G3600810063301,36,81,63301,10,113,123,0.08130081
G3600810063302,36,81,63302,10,127,137,0.072992697
G3600810063500,36,81,63500,16,206,222,0.072072074
G3600810063700,36,81,63700,28,261,289,0.096885815
G3600810063800,36,81,63800,48,292,340,0.14117648
G3600810063900,36,81,63900,0,205,205,0
G3600810064101,36,81,64101,46,107,153,0.30065361
G3600810064102,36,81,64102,0,0,0,
G3600810064500,36,81,64500,17,123,140,0.12142857
G3600810064600,36,81,64600,73,170,243,0.30041152
G3600810065000,36,81,65000,13,302,315,0.041269843
G3600810065400,36,81,65400,16,387,403,0.039702233
G3600810065501,36,81,65501,0,0,0,
G3600810065600,36,81,65600,93,573,666,0.13963965
G3600810065702,36,81,65702,0,95,95,0
G3600810065703,36,81,65703,0,211,211,0
G3600810065900,36,81,65900,12,131,143,0.083916083
G3600810066000,36,81,66000,10,356,366,0.027322404
G3600810066100,36,81,66100,0,79,79,0
G3600810066300,36,81,66300,23,211,234,0.0982906
G3600810066400,36,81,66400,121,1147,1268,0.095425867
G3600810066501,36,81,66501,34,226,260,0.13076924
G3600810066701,36,81,66701,35,201,236,0.14830509
G3600810066900,36,81,66900,0,138,138,0
G3600810067100,36,81,67100,0,182,182,0
G3600810067700,36,81,67700,0,150,150,0
G3600810067900,36,81,67900,66,204,270,0.24444444
G3600810068000,36,81,68000,22,480,502,0.043824703
G3600810068200,36,81,68200,28,107,135,0.2074074
G3600810068300,36,81,68300,137,223,360,0.38055557
G3600810068700,36,81,68700,90,133,223,0.40358743
G3600810069000,36,81,69000,58,347,405,0.14320987
G3600810069300,36,81,69300,71,194,265,0.26792452
G3600810069400,36,81,69400,125,317,442,0.28280544
G3600810069500,36,81,69500,8,92,100,0.079999998
G3600810069701,36,81,69701,34,251,285,0.11929824
G3600810069702,36,81,69702,22,175,197,0.11167513
G3600810070300,36,81,70300,7,119,126,0.055555556
G3600810070700,36,81,70700,34,217,251,0.13545817
G3600810070900,36,81,70900,10,199,209,0.047846891
G3600810071100,36,81,71100,0,365,365,0
G3600810071303,36,81,71303,34,273,307,0.11074919
G3600810071304,36,81,71304,65,347,412,0.15776698
G3600810071305,36,81,71305,14,278,292,0.047945205
G3600810071306,36,81,71306,101,282,383,0.26370758
G3600810071600,36,81,71600,0,0,0,
G3600810071701,36,81,71701,69,257,326,0.21165644
G3600810071702,36,81,71702,155,327,482,0.32157677
G3600810071900,36,81,71900,15,121,136,0.11029412
G3600810072100,36,81,72100,108,214,322,0.33540374
G3600810072300,36,81,72300,8,188,196,0.040816326
G3600810072900,36,81,72900,0,118,118,0
G3600810073100,36,81,73100,0,142,142,0
G3600810073700,36,81,73700,0,89,89,0
G3600810073900,36,81,73900,12,476,488,0.024590164
G3600810074100,36,81,74100,30,177,207,0.14492753
G3600810074300,36,81,74300,16,327,343,0.046647232
G3600810074500,36,81,74500,34,304,338,0.10059172
G3600810074700,36,81,74700,7,296,303,0.02310231
G3600810074900,36,81,74900,0,168,168,0
G3600810075701,36,81,75701,0,312,312,0
G3600810075702,36,81,75702,15,241,256,0.05859375
G3600810076901,36,81,76901,0,291,291,0
G3600810076902,36,81,76902,21,88,109,0.19266056
G3600810077300,36,81,77300,7,137,144,0.048611112
G3600810077500,36,81,77500,0,112,112,0
G3600810077902,36,81,77902,119,381,500,0.23800001
G3600810077903,36,81,77903,56,207,263,0.21292776
G3600810077904,36,81,77904,62,452,514,0.12062257
G3600810077905,36,81,77905,0,182,182,0
G3600810077906,36,81,77906,61,209,270,0.22592592
G3600810077907,36,81,77907,6,197,203,0.029556651
G3600810077908,36,81,77908,180,313,493,0.36511156
G3600810078800,36,81,78800,12,176,188,0.063829787
G3600810079000,36,81,79000,65,135,200,0.32499999
G3600810079200,36,81,79200,67,216,283,0.23674911
G3600810079300,36,81,79300,0,0,0,
G3600810079701,36,81,79701,22,627,649,0.033898305
G3600810079702,36,81,79702,168,303,471,0.3566879
G3600810079900,36,81,79900,128,233,361,0.35457063
G3600810080301,36,81,80301,8,328,336,0.023809524
G3600810080302,36,81,80302,59,269,328,0.17987806
G3600810080900,36,81,80900,129,342,471,0.27388534
G3600810081400,36,81,81400,145,329,474,0.30590716
G3600810081800,36,81,81800,164,349,513,0.31968811
G3600810083700,36,81,83700,127,304,431,0.29466358
G3600810083800,36,81,83800,54,575,629,0.085850559
G3600810084000,36,81,84000,57,568,625,0.091200002
G3600810084500,36,81,84500,0,277,277,0
G3600810084601,36,81,84601,37,235,272,0.13602941
G3600810084602,36,81,84602,13,128,141,0.092198581
G3600810084900,36,81,84900,456,414,870,0.52413791
G3600810085300,36,81,85300,33,226,259,0.12741312
G3600810085500,36,81,85500,219,582,801,0.27340823
G3600810085700,36,81,85700,226,311,537,0.42085662
G3600810085900,36,81,85900,114,247,361,0.31578946
G3600810086100,36,81,86100,56,136,192,0.29166666
G3600810086300,36,81,86300,123,317,440,0.27954546
G3600810086400,36,81,86400,63,207,270,0.23333333
G3600810086500,36,81,86500,59,115,174,0.33908045
G3600810086900,36,81,86900,80,83,163,0.49079755
G3600810087100,36,81,87100,143,124,267,0.53558052
G3600810088400,36,81,88400,45,674,719,0.062586926
G3600810088901,36,81,88901,575,378,953,0.60335779
G3600810089200,36,81,89200,11,674,685,0.016058395
G3600810090700,36,81,90700,34,84,118,0.28813559
G3600810091601,36,81,91601,29,404,433,0.066974595
G3600810091602,36,81,91602,0,0,0,
G3600810091800,36,81,91800,0,0,0,
G3600810091900,36,81,91900,118,383,501,0.23552895
G3600810092200,36,81,92200,0,207,207,0
G3600810092500,36,81,92500,157,258,415,0.37831324
G3600810092800,36,81,92800,0,261,261,0
G3600810092900,36,81,92900,101,559,660,0.15303031
G3600810093401,36,81,93401,11,356,367,0.029972753
G3600810093402,36,81,93402,0,234,234,0
G3600810093800,36,81,93800,26,484,510,0.050980393
G3600810093900,36,81,93900,90,444,534,0.16853933
G3600810094201,36,81,94201,39,291,330,0.11818182
G3600810094202,36,81,94202,209,414,623,0.33547351
G3600810094203,36,81,94203,12,431,443,0.027088037
G3600810094500,36,81,94500,46,359,405,0.11358025
G3600810094700,36,81,94700,73,226,299,0.24414715
G3600810095400,36,81,95400,108,392,500,0.21600001
G3600810096400,36,81,96400,103,322,425,0.24235295
G3600810097202,36,81,97202,106,265,371,0.2857143
G3600810097203,36,81,97203,510,601,1111,0.45904592
G3600810097204,36,81,97204,121,305,426,0.28403756
G3600810097300,36,81,97300,0,170,170,0
G3600810098100,36,81,98100,22,185,207,0.10628019
G3600810098700,36,81,98700,5,253,258,0.019379845
G3600810099100,36,81,99100,0,414,414,0
G3600810099200,36,81,99200,158,433,591,0.26734349
G3600810099701,36,81,99701,7,128,135,0.05185185
G3600810099703,36,81,99703,0,201,201,0
G3600810099704,36,81,99704,47,388,435,0.10804598
G3600810099705,36,81,99705,10,130,140,0.071428575
G3600810099801,36,81,99801,178,812,990,0.17979798
G3600810099802,36,81,99802,75,279,354,0.21186441
G3600810099900,36,81,99900,0,0,0,
G3600810100801,36,81,100801,25,175,200,0.125
G3600810100802,36,81,100802,193,760,953,0.20251836
G3600810101001,36,81,101001,321,620,941,0.34112647
G3600810101002,36,81,101002,71,197,268,0.26492536
G3600810101700,36,81,101700,30,413,443,0.067720093
G3600810102900,36,81,102900,31,328,359,0.086350977
G3600810103201,36,81,103201,298,506,804,0.37064677
G3600810103202,36,81,103202,80,466,546,0.14652015
G3600810103300,36,81,103300,63,335,398,0.15829146
G3600810103900,36,81,103900,27,472,499,0.054108217
G3600810104700,36,81,104700,0,672,672,0
G3600810105900,36,81,105900,20,330,350,0.057142857
G3600810107201,36,81,107201,16,135,151,0.10596026
G3600810107202,36,81,107202,0,0,0,
G3600810108500,36,81,108500,74,169,243,0.30452675
G3600810109300,36,81,109300,0,342,342,0
G3600810109700,36,81,109700,0,112,112,0
G3600810109900,36,81,109900,29,271,300,0.096666664
G3600810111300,36,81,111300,37,219,256,0.14453125
G3600810112300,36,81,112300,61,158,219,0.27853882
G3600810112900,36,81,112900,42,129,171,0.24561404
G3600810113300,36,81,113300,6,175,181,0.033149172
G3600810113900,36,81,113900,41,210,251,0.16334662
G3600810114100,36,81,114100,0,147,147,0
G3600810114700,36,81,114700,42,119,161,0.26086956
G3600810115100,36,81,115100,10,74,84,0.11904762
G3600810115500,36,81,115500,0,151,151,0
G3600810115700,36,81,115700,87,204,291,0.29896906
G3600810115900,36,81,115900,34,270,304,0.1118421
G3600810116100,36,81,116100,68,195,263,0.25855514
G3600810116300,36,81,116300,234,222,456,0.5131579
G3600810116700,36,81,116700,93,64,157,0.59235668
G3600810117100,36,81,117100,54,224,278,0.19424461
G3600810117500,36,81,117500,58,300,358,0.16201118
G3600810118100,36,81,118100,30,62,92,0.32608697
G3600810118500,36,81,118500,59,140,199,0.29648241
G3600810118700,36,81,118700,87,129,216,0.40277779
G3600810118900,36,81,118900,88,135,223,0.39461884
G3600810119100,36,81,119100,50,243,293,0.17064847
G3600810119300,36,81,119300,56,134,190,0.29473683
G3600810119500,36,81,119500,0,123,123,0
G3600810119900,36,81,119900,48,88,136,0.35294119
G3600810120100,36,81,120100,46,114,160,0.28749999
G3600810120300,36,81,120300,105,146,251,0.41832671
G3600810120500,36,81,120500,99,100,199,0.49748743
G3600810120700,36,81,120700,2,223,225,0.008888889
G3600810121100,36,81,121100,0,0,0,
G3600810121500,36,81,121500,71,248,319,0.22257054
G3600810122300,36,81,122300,64,248,312,0.20512821
G3600810122701,36,81,122701,137,1043,1180,0.1161017
G3600810122702,36,81,122702,414,466,880,0.47045454
G3600810124100,36,81,124100,8,227,235,0.034042552
G3600810124700,36,81,124700,27,286,313,0.08626198
G3600810125700,36,81,125700,100,260,360,0.27777779
G3600810126500,36,81,126500,42,127,169,0.24852072
G3600810126700,36,81,126700,14,227,241,0.058091287
G3600810127700,36,81,127700,62,324,386,0.16062176
G3600810128300,36,81,128300,0,0,0,
G3600810129102,36,81,129102,0,239,239,0
G3600810129103,36,81,129103,10,197,207,0.048309177
G3600810129104,36,81,129104,20,357,377,0.053050399
G3600810130100,36,81,130100,36,330,366,0.098360658
G3600810133300,36,81,133300,14,315,329,0.04255319
G3600810133900,36,81,133900,5,69,74,0.067567565
G3600810134100,36,81,134100,82,358,440,0.18636364
G3600810134700,36,81,134700,40,630,670,0.059701491
G3600810136700,36,81,136700,32,647,679,0.04712813
G3600810137700,36,81,137700,153,526,679,0.22533137
G3600810138501,36,81,138501,16,526,542,0.029520296
G3600810138502,36,81,138502,0,0,0,
G3600810139900,36,81,139900,10,162,172,0.058139537
G3600810140300,36,81,140300,22,192,214,0.10280374
G3600810140901,36,81,140901,10,81,91,0.10989011
G3600810140902,36,81,140902,51,274,325,0.15692307
G3600810141700,36,81,141700,31,291,322,0.096273296
G3600810142900,36,81,142900,84,193,277,0.30324909
G3600810143500,36,81,143500,12,177,189,0.063492067
G3600810144100,36,81,144100,11,236,247,0.044534411
G3600810144700,36,81,144700,78,273,351,0.22222222
G3600810145101,36,81,145101,0,169,169,0
G3600810145102,36,81,145102,13,183,196,0.066326529
G3600810145900,36,81,145900,0,226,226,0
G3600810146300,36,81,146300,63,206,269,0.23420075
G3600810146700,36,81,146700,0,275,275,0
G3600810147100,36,81,147100,12,199,211,0.056872036
G3600810147900,36,81,147900,92,443,535,0.17196262
G3600810148300,36,81,148300,28,296,324,0.086419754
G3600810150701,36,81,150701,12,229,241,0.049792532
G3600810150702,36,81,150702,16,216,232,0.068965517
G3600810152901,36,81,152901,16,455,471,0.033970278
G3600810152902,36,81,152902,6,369,375,0.016000001
G3600810155101,36,81,155101,0,0,0,
G3600810155102,36,81,155102,18,395,413,0.043583535
G3600810156700,36,81,156700,15,46,61,0.24590164
G3600810157101,36,81,157101,26,462,488,0.053278688
G3600810157102,36,81,157102,57,199,256,0.22265625
G3600810157901,36,81,157901,42,234,276,0.15217391
G3600810157902,36,81,157902,86,287,373,0.230563
G3600810157903,36,81,157903,29,303,332,0.0873494
G3600810161700,36,81,161700,30,362,392,0.076530613
G3600810162100,36,81,162100,215,610,825,0.26060605
G3600810990100,36,81,990100,0,0,0,
G3600830040100,36,83,40100,185,319,504,0.36706349
G3600830040200,36,83,40200,220,352,572,0.38461539
G3600830040300,36,83,40300,117,153,270,0.43333334
G3600830040400,36,83,40400,171,105,276,0.61956519
G3600830040500,36,83,40500,114,68,182,0.62637365
G3600830040600,36,83,40600,19,49,68,0.27941176
G3600830040700,36,83,40700,151,52,203,0.74384236
G3600830040800,36,83,40800,12,81,93,0.12903225
G3600830040900,36,83,40900,138,194,332,0.41566265
G3600830041000,36,83,41000,139,166,305,0.45573771
G3600830041100,36,83,41100,148,334,482,0.30705395
G3600830041200,36,83,41200,0,160,160,0
G3600830041300,36,83,41300,23,118,141,0.16312057
G3600830041400,36,83,41400,41,196,237,0.17299578
G3600830051500,36,83,51500,112,100,212,0.52830189
G3600830051600,36,83,51600,156,389,545,0.28623852
G3600830051701,36,83,51701,21,262,283,0.074204944
G3600830051702,36,83,51702,54,320,374,0.14438502
G3600830051800,36,83,51800,82,497,579,0.14162348
G3600830051901,36,83,51901,32,399,431,0.074245937
G3600830051902,36,83,51902,30,276,306,0.098039217
G3600830052002,36,83,52002,0,182,182,0
G3600830052003,36,83,52003,7,312,319,0.021943573
G3600830052004,36,83,52004,0,509,509,0
G3600830052101,36,83,52101,45,147,192,0.234375
G3600830052102,36,83,52102,7,118,125,0.056000002
G3600830052103,36,83,52103,0,129,129,0
G3600830052201,36,83,52201,28,468,496,0.056451611
G3600830052203,36,83,52203,0,429,429,0
G3600830052204,36,83,52204,7,324,331,0.021148037
G3600830052301,36,83,52301,34,337,371,0.091644205
G3600830052303,36,83,52303,23,132,155,0.14838709
G3600830052304,36,83,52304,11,453,464,0.023706896
G3600830052402,36,83,52402,0,231,231,0
G3600830052403,36,83,52403,80,561,641,0.12480499
G3600830052404,36,83,52404,17,782,799,0.021276595
G3600830052501,36,83,52501,16,560,576,0.027777778
G3600830052502,36,83,52502,62,489,551,0.11252268
G3600830052503,36,83,52503,0,133,133,0
G3600830052601,36,83,52601,5,327,332,0.015060241
G3600830052602,36,83,52602,6,100,106,0.056603774
G3600830052603,36,83,52603,50,281,331,0.15105741
G3600850000300,36,85,300,0,98,98,0
G3600850000600,36,85,600,34,79,113,0.30088496
G3600850000700,36,85,700,212,370,582,0.36426118
G3600850000800,36,85,800,62,620,682,0.090909094
G3600850000900,36,85,900,52,225,277,0.18772563
G3600850001100,36,85,1100,126,270,396,0.31818181
G3600850001700,36,85,1700,96,117,213,0.45070422
G3600850001800,36,85,1800,0,85,85,0
G3600850002001,36,85,2001,6,221,227,0.026431719
G3600850002002,36,85,2002,32,249,281,0.113879
G3600850002100,36,85,2100,167,258,425,0.39294118
G3600850002700,36,85,2700,31,115,146,0.21232876
G3600850002900,36,85,2900,264,483,747,0.35341364
G3600850003300,36,85,3300,21,406,427,0.049180329
G3600850003600,36,85,3600,44,267,311,0.1414791
G3600850003900,36,85,3900,0,124,124,0
G3600850004000,36,85,4000,591,1270,1861,0.31757119
G3600850004700,36,85,4700,0,203,203,0
G3600850005000,36,85,5000,79,413,492,0.1605691
G3600850005900,36,85,5900,0,221,221,0
G3600850006400,36,85,6400,82,207,289,0.28373703
G3600850006700,36,85,6700,48,212,260,0.18461539
G3600850007000,36,85,7000,195,745,940,0.20744681
G3600850007400,36,85,7400,109,446,555,0.1963964
G3600850007500,36,85,7500,271,328,599,0.45242071
G3600850007700,36,85,7700,57,151,208,0.27403846
G3600850008100,36,85,8100,130,210,340,0.38235295
G3600850009601,36,85,9601,0,199,199,0
G3600850009602,36,85,9602,0,325,325,0
G3600850009700,36,85,9700,115,443,558,0.20609319
G3600850010500,36,85,10500,60,454,514,0.11673152
G3600850011201,36,85,11201,20,590,610,0.032786883
G3600850011202,36,85,11202,53,571,624,0.084935896
G3600850011401,36,85,11401,120,182,302,0.397351
G3600850011402,36,85,11402,0,364,364,0
G3600850012100,36,85,12100,67,262,329,0.20364742
G3600850012200,36,85,12200,0,335,335,0
G3600850012500,36,85,12500,64,202,266,0.24060151
G3600850012804,36,85,12804,66,361,427,0.15456675
G3600850012805,36,85,12805,34,226,260,0.13076924
G3600850012806,36,85,12806,69,566,635,0.10866142
G3600850013201,36,85,13201,0,140,140,0
G3600850013203,36,85,13203,53,475,528,0.10037879
G3600850013204,36,85,13204,96,340,436,0.22018349
G3600850013301,36,85,13301,180,42,222,0.8108108
G3600850013302,36,85,13302,112,418,530,0.21132076
G3600850013400,36,85,13400,74,271,345,0.21449275
G3600850013800,36,85,13800,0,558,558,0
G3600850014100,36,85,14100,136,206,342,0.39766082
G3600850014604,36,85,14604,240,480,720,0.33333334
G3600850014605,36,85,14605,0,343,343,0
G3600850014606,36,85,14606,33,720,753,0.043824703
G3600850014607,36,85,14607,57,427,484,0.11776859
G3600850014608,36,85,14608,24,326,350,0.068571426
G3600850014700,36,85,14700,16,296,312,0.051282052
G3600850015100,36,85,15100,22,461,483,0.045548655
G3600850015400,36,85,15400,0,0,0,
G3600850015601,36,85,15601,66,544,610,0.10819672
G3600850015602,36,85,15602,18,297,315,0.057142857
G3600850015603,36,85,15603,43,382,425,0.10117647
G3600850016901,36,85,16901,19,364,383,0.049608354
G3600850017005,36,85,17005,8,512,520,0.015384615
G3600850017007,36,85,17007,55,692,747,0.073627844
G3600850017008,36,85,17008,0,638,638,0
G3600850017009,36,85,17009,56,394,450,0.12444445
G3600850017010,36,85,17010,166,915,1081,0.15356152
G3600850017011,36,85,17011,64,344,408,0.15686275
G3600850017012,36,85,17012,43,374,417,0.1031175
G3600850017300,36,85,17300,74,184,258,0.28682169
G3600850017600,36,85,17600,39,504,543,0.071823202
G3600850017700,36,85,17700,0,708,708,0
G3600850018100,36,85,18100,82,203,285,0.28771931
G3600850018701,36,85,18701,51,146,197,0.25888324
G3600850018702,36,85,18702,4,468,472,0.008474576
G3600850018901,36,85,18901,117,411,528,0.22159091
G3600850018902,36,85,18902,176,463,639,0.27543035
G3600850019700,36,85,19700,0,142,142,0
G3600850019800,36,85,19800,24,802,826,0.02905569
G3600850020100,36,85,20100,123,289,412,0.29854369
G3600850020700,36,85,20700,168,553,721,0.23300971
G3600850020801,36,85,20801,175,733,908,0.19273128
G3600850020803,36,85,20803,55,706,761,0.072273321
G3600850020804,36,85,20804,58,401,459,0.12636165
G3600850021300,36,85,21300,252,293,545,0.46238533
G3600850022300,36,85,22300,67,277,344,0.19476745
G3600850022600,36,85,22600,0,1129,1129,0
G3600850022800,36,85,22800,0,0,0,
G3600850023100,36,85,23100,119,505,624,0.19070514
G3600850023900,36,85,23900,117,345,462,0.25324675
G3600850024401,36,85,24401,72,625,697,0.10329986
G3600850024402,36,85,24402,31,507,538,0.05762082
G3600850024700,36,85,24700,33,288,321,0.10280374
G3600850024800,36,85,24800,100,446,546,0.18315019
G3600850025100,36,85,25100,30,446,476,0.063025214
G3600850027301,36,85,27301,138,310,448,0.3080357
G3600850027302,36,85,27302,20,263,283,0.07067138
G3600850027702,36,85,27702,56,550,606,0.092409238
G3600850027704,36,85,27704,18,423,441,0.040816326
G3600850027705,36,85,27705,20,512,532,0.037593983
G3600850027706,36,85,27706,65,258,323,0.20123839
G3600850027900,36,85,27900,0,150,150,0
G3600850029102,36,85,29102,32,339,371,0.086253367
G3600850029103,36,85,29103,28,576,604,0.046357617
G3600850029104,36,85,29104,57,729,786,0.072519086
G3600850030301,36,85,30301,35,441,476,0.073529415
G3600850030302,36,85,30302,215,643,858,0.25058275
G3600850031901,36,85,31901,199,178,377,0.52785146
G3600850031902,36,85,31902,279,424,703,0.39687055
G3600850032300,36,85,32300,20,59,79,0.25316456
G3600850990100,36,85,990100,0,0,0,
G3600870010101,36,87,10101,40,562,602,0.066445179
G3600870010102,36,87,10102,29,612,641,0.04524181
G3600870010200,36,87,10200,70,437,507,0.13806707
G3600870010501,36,87,10501,16,524,540,0.029629629
G3600870010502,36,87,10502,71,731,802,0.088528678
G3600870010503,36,87,10503,5,173,178,0.028089888
G3600870010601,36,87,10601,43,326,369,0.11653116
G3600870010602,36,87,10602,85,688,773,0.10996119
G3600870010701,36,87,10701,52,425,477,0.10901468
G3600870010702,36,87,10702,162,333,495,0.32727271
G3600870010703,36,87,10703,58,363,421,0.13776723
G3600870010801,36,87,10801,26,445,471,0.055201698
G3600870010802,36,87,10802,0,469,469,0
G3600870010803,36,87,10803,52,556,608,0.085526317
G3600870010804,36,87,10804,28,408,436,0.064220183
G3600870010901,36,87,10901,7,574,581,0.012048192
G3600870010902,36,87,10902,28,417,445,0.062921345
G3600870011000,36,87,11000,0,188,188,0
G3600870011101,36,87,11101,138,540,678,0.20353982
G3600870011102,36,87,11102,24,593,617,0.038897894
G3600870011200,36,87,11200,36,663,699,0.051502146
G3600870011301,36,87,11301,92,549,641,0.14352573
G3600870011302,36,87,11302,0,627,627,0
G3600870011303,36,87,11303,15,580,595,0.025210084
G3600870011401,36,87,11401,19,431,450,0.04222222
G3600870011403,36,87,11403,0,561,561,0
G3600870011404,36,87,11404,26,264,290,0.089655176
G3600870011405,36,87,11405,7,448,455,0.015384615
G3600870011501,36,87,11501,47,715,762,0.061679792
G3600870011502,36,87,11502,55,863,918,0.059912853
G3600870011504,36,87,11504,56,514,570,0.098245613
G3600870011505,36,87,11505,111,114,225,0.49333334
G3600870011506,36,87,11506,191,145,336,0.56845236
G3600870011601,36,87,11601,10,398,408,0.024509804
G3600870011602,36,87,11602,72,612,684,0.10526316
G3600870011603,36,87,11603,30,545,575,0.052173913
G3600870011700,36,87,11700,18,362,380,0.047368422
G3600870011800,36,87,11800,10,98,108,0.09259259
G3600870011901,36,87,11901,35,363,398,0.087939702
G3600870011902,36,87,11902,40,353,393,0.10178117
G3600870012000,36,87,12000,40,321,361,0.11080332
G3600870012101,36,87,12101,46,470,516,0.089147285
G3600870012102,36,87,12102,171,347,518,0.33011582
G3600870012103,36,87,12103,168,352,520,0.32307693
G3600870012105,36,87,12105,114,304,418,0.27272728
G3600870012106,36,87,12106,38,244,282,0.13475177
G3600870012202,36,87,12202,224,524,748,0.29946524
G3600870012203,36,87,12203,60,246,306,0.19607843
G3600870012204,36,87,12204,82,297,379,0.21635884
G3600870012300,36,87,12300,260,463,723,0.35961273
G3600870012401,36,87,12401,77,419,496,0.15524194
G3600870012402,36,87,12402,249,260,509,0.48919451
G3600870012501,36,87,12501,4,502,506,0.007905139
G3600870012502,36,87,12502,7,370,377,0.018567638
G3600870012600,36,87,12600,158,660,818,0.19315404
G3600870012700,36,87,12700,20,350,370,0.054054055
G3600870012800,36,87,12800,15,724,739,0.020297699
G3600870013001,36,87,13001,6,278,284,0.02112676
G3600870013002,36,87,13002,0,561,561,0
G3600870013003,36,87,13003,28,190,218,0.12844037
G3600870013100,36,87,13100,30,395,425,0.070588239
G3600870013200,36,87,13200,37,273,310,0.11935484
G3600870013300,36,87,13300,27,174,201,0.13432837
G3600870013401,36,87,13401,18,493,511,0.035225049
G3600870013402,36,87,13402,26,493,519,0.05009634
G3600890490100,36,89,490100,123,275,398,0.30904523
G3600890490200,36,89,490200,50,343,393,0.12722646
G3600890490300,36,89,490300,165,458,623,0.26484752
G3600890490400,36,89,490400,75,222,297,0.25252524
G3600890490500,36,89,490500,134,236,370,0.36216217
G3600890490600,36,89,490600,106,407,513,0.20662768
G3600890490700,36,89,490700,79,447,526,0.15019011
G3600890490800,36,89,490800,24,229,253,0.094861656
G3600890490900,36,89,490900,53,222,275,0.19272727
G3600890491000,36,89,491000,63,444,507,0.12426036
G3600890491100,36,89,491100,0,0,0,
G3600890491200,36,89,491200,0,0,0,
G3600890491300,36,89,491300,18,406,424,0.042452831
G3600890491400,36,89,491400,64,238,302,0.21192053
G3600890491500,36,89,491500,112,289,401,0.27930173
G3600890491600,36,89,491600,31,175,206,0.15048544
G3600890491700,36,89,491700,91,317,408,0.22303921
G3600890491800,36,89,491800,95,273,368,0.25815219
G3600890491900,36,89,491900,0,0,0,
G3600890492000,36,89,492000,65,369,434,0.14976959
G3600890492100,36,89,492100,89,181,270,0.32962963
G3600890492300,36,89,492300,123,470,593,0.2074199
G3600890492400,36,89,492400,51,210,261,0.19540229
G3600890492500,36,89,492500,88,125,213,0.41314554
G3600890492600,36,89,492600,101,471,572,0.17657343
G3600890492700,36,89,492700,217,470,687,0.31586608
G3600890492800,36,89,492800,53,168,221,0.23981901
G3600890492900,36,89,492900,54,166,220,0.24545455
G3600910060101,36,91,60101,73,538,611,0.11947627
G3600910060102,36,91,60102,17,591,608,0.027960526
G3600910060200,36,91,60200,17,243,260,0.065384619
G3600910060300,36,91,60300,88,242,330,0.26666668
G3600910060400,36,91,60400,35,179,214,0.16355141
G3600910060501,36,91,60501,7,151,158,0.044303797
G3600910060502,36,91,60502,25,106,131,0.19083969
G3600910060503,36,91,60503,0,189,189,0
G3600910060601,36,91,60601,84,212,296,0.28378379
G3600910060602,36,91,60602,9,474,483,0.018633541
G3600910060701,36,91,60701,45,711,756,0.05952381
G3600910060702,36,91,60702,60,964,1024,0.05859375
G3600910060800,36,91,60800,25,520,545,0.04587156
G3600910060901,36,91,60901,11,424,435,0.025287356
G3600910060902,36,91,60902,27,146,173,0.15606937
G3600910061000,36,91,61000,0,156,156,0
G3600910061100,36,91,61100,104,361,465,0.22365591
G3600910061200,36,91,61200,0,266,266,0
G3600910061301,36,91,61301,15,325,340,0.044117648
G3600910061302,36,91,61302,0,549,549,0
G3600910061303,36,91,61303,0,0,0,
G3600910061401,36,91,61401,135,465,600,0.22499999
G3600910061403,36,91,61403,51,677,728,0.070054948
G3600910061404,36,91,61404,36,304,340,0.10588235
G3600910061500,36,91,61500,18,312,330,0.054545455
G3600910061600,36,91,61600,9,369,378,0.023809524
G3600910061701,36,91,61701,64,466,530,0.12075472
G3600910061702,36,91,61702,8,447,455,0.017582418
G3600910061800,36,91,61800,44,415,459,0.095860563
G3600910061901,36,91,61901,22,741,763,0.028833551
G3600910061903,36,91,61903,16,506,522,0.03065134
G3600910062000,36,91,62000,74,614,688,0.10755814
G3600910062100,36,91,62100,42,208,250,0.168
G3600910062200,36,91,62200,73,222,295,0.24745762
G3600910062300,36,91,62300,57,161,218,0.2614679
G3600910062403,36,91,62403,100,487,587,0.17035775
G3600910062404,36,91,62404,5,100,105,0.047619049
G3600910062405,36,91,62405,168,492,660,0.25454545
G3600910062406,36,91,62406,54,428,482,0.1120332
G3600910062501,36,91,62501,36,487,523,0.068833649
G3600910062503,36,91,62503,0,600,600,0
G3600910062505,36,91,62505,9,362,371,0.024258761
G3600910062506,36,91,62506,0,607,607,0
G3600910062507,36,91,62507,31,335,366,0.084699452
G3600910062508,36,91,62508,55,325,380,0.14473684
G3600910062509,36,91,62509,0,221,221,0
G3600910062601,36,91,62601,5,244,249,0.020080321
G3600910062602,36,91,62602,0,812,812,0
G3600910062700,36,91,62700,94,508,602,0.15614618
G3600910062800,36,91,62800,27,125,152,0.17763157
G3600930020101,36,93,20101,0,120,120,0
G3600930020102,36,93,20102,76,220,296,0.25675675
G3600930020200,36,93,20200,70,111,181,0.38674033
G3600930020300,36,93,20300,10,80,90,0.11111111
G3600930020500,36,93,20500,52,313,365,0.14246576
G3600930020600,36,93,20600,6,177,183,0.032786883
G3600930020700,36,93,20700,258,278,536,0.48134327
G3600930020800,36,93,20800,82,132,214,0.38317758
G3600930020900,36,93,20900,225,57,282,0.79787236
G3600930021001,36,93,21001,23,3,26,0.88461536
G3600930021002,36,93,21002,118,44,162,0.72839504
G3600930021200,36,93,21200,38,137,175,0.21714285
G3600930021400,36,93,21400,84,196,280,0.30000001
G3600930021500,36,93,21500,117,183,300,0.38999999
G3600930021600,36,93,21600,117,185,302,0.38741723
G3600930021700,36,93,21700,159,189,348,0.45689654
G3600930021800,36,93,21800,0,451,451,0
G3600930031900,36,93,31900,38,572,610,0.062295083
G3600930032000,36,93,32000,22,598,620,0.035483871
G3600930032101,36,93,32101,45,535,580,0.077586204
G3600930032102,36,93,32102,29,190,219,0.13242009
G3600930032200,36,93,32200,25,409,434,0.057603687
G3600930032300,36,93,32300,6,232,238,0.025210084
G3600930032402,36,93,32402,14,291,305,0.045901638
G3600930032403,36,93,32403,5,147,152,0.032894738
G3600930032404,36,93,32404,0,506,506,0
G3600930032502,36,93,32502,20,286,306,0.065359481
G3600930032503,36,93,32503,22,382,404,0.054455444
G3600930032504,36,93,32504,0,141,141,0
G3600930032601,36,93,32601,23,169,192,0.11979166
G3600930032602,36,93,32602,0,271,271,0
G3600930032700,36,93,32700,67,352,419,0.15990454
G3600930032901,36,93,32901,0,279,279,0
G3600930032902,36,93,32902,5,346,351,0.014245015
G3600930033002,36,93,33002,16,214,230,0.069565214
G3600930033003,36,93,33003,28,228,256,0.109375
G3600930033004,36,93,33004,64,170,234,0.27350429
G3600930033101,36,93,33101,0,144,144,0
G3600930033102,36,93,33102,72,555,627,0.11483254
G3600930033200,36,93,33200,99,162,261,0.37931034
G3600930033300,36,93,33300,20,134,154,0.12987013
G3600930033400,36,93,33400,9,91,100,0.090000004
G3600930033500,36,93,33500,0,9,9,0
G3600950740100,36,95,740100,75,309,384,0.1953125
G3600950740200,36,95,740200,47,330,377,0.12466843
G3600950740300,36,95,740300,0,0,0,
G3600950740400,36,95,740400,144,406,550,0.26181817
G3600950740500,36,95,740500,56,310,366,0.15300547
G3600950740600,36,95,740600,49,236,285,0.17192982
G3600950740700,36,95,740700,71,322,393,0.18066157
G3600950740800,36,95,740800,18,245,263,0.068441063
G3600970950100,36,97,950100,1,348,349,0.00286533
G3600970950200,36,97,950200,2,103,105,0.01904762
G3600970950300,36,97,950300,73,162,235,0.31063831
G3600970950400,36,97,950400,26,221,247,0.10526316
G3600970950500,36,97,950500,100,247,347,0.28818443
G3600990950100,36,99,950100,8,182,190,0.042105265
G3600990950200,36,99,950200,21,148,169,0.12426036
G3600990950300,36,99,950300,31,290,321,0.096573211
G3600990950400,36,99,950400,39,216,255,0.15294118
G3600990950500,36,99,950500,42,299,341,0.12316716
G3600990950600,36,99,950600,90,261,351,0.25641027
G3600990950700,36,99,950700,16,325,341,0.046920821
G3600990950800,36,99,950800,20,269,289,0.069204152
G3600990950900,36,99,950900,32,245,277,0.11552346
G3600990951000,36,99,951000,37,179,216,0.1712963
G3601010960100,36,101,960100,24,111,135,0.17777778
G3601010960200,36,101,960200,29,249,278,0.10431655
G3601010960300,36,101,960300,40,231,271,0.14760147
G3601010960400,36,101,960400,108,291,399,0.2706767
G3601010960500,36,101,960500,26,202,228,0.11403508
G3601010960600,36,101,960600,41,310,351,0.11680911
G3601010960700,36,101,960700,79,230,309,0.25566342
G3601010960800,36,101,960800,141,235,376,0.375
G3601010960900,36,101,960900,55,110,165,0.33333334
G3601010961000,36,101,961000,66,291,357,0.18487395
G3601010961100,36,101,961100,186,284,470,0.39574468
G3601010961200,36,101,961200,67,201,268,0.25
G3601010961300,36,101,961300,166,299,465,0.35698923
G3601010961400,36,101,961400,11,176,187,0.05882353
G3601010961500,36,101,961500,30,124,154,0.19480519
G3601010961600,36,101,961600,38,164,202,0.18811882
G3601010961700,36,101,961700,11,301,312,0.035256412
G3601010961800,36,101,961800,114,224,338,0.3372781
G3601010961900,36,101,961900,82,272,354,0.23163842
G3601010962000,36,101,962000,78,349,427,0.18266979
G3601010962100,36,101,962100,114,222,336,0.3392857
G3601010962200,36,101,962200,72,240,312,0.23076923
G3601010962300,36,101,962300,99,776,875,0.11314286
G3601010962400,36,101,962400,10,303,313,0.031948883
G3601010962500,36,101,962500,62,140,202,0.30693069
G3601010962600,36,101,962600,71,271,342,0.20760234
G3601010962700,36,101,962700,27,172,199,0.1356784
G3601010962800,36,101,962800,33,318,351,0.094017096
G3601010962900,36,101,962900,42,239,281,0.14946619
G3601010963000,36,101,963000,38,379,417,0.091127098
G3601030110101,36,103,110101,31,489,520,0.059615385
G3601030110102,36,103,110102,0,562,562,0
G3601030110200,36,103,110200,22,390,412,0.053398058
G3601030110300,36,103,110300,17,435,452,0.03761062
G3601030110401,36,103,110401,0,227,227,0
G3601030110402,36,103,110402,17,397,414,0.041062802
G3601030110501,36,103,110501,12,324,336,0.035714287
G3601030110502,36,103,110502,0,346,346,0
G3601030110600,36,103,110600,0,830,830,0
G3601030110801,36,103,110801,0,168,168,0
G3601030110803,36,103,110803,52,627,679,0.076583214
G3601030110901,36,103,110901,0,184,184,0
G3601030110902,36,103,110902,53,472,525,0.10095238
G3601030111001,36,103,111001,25,175,200,0.125
G3601030111002,36,103,111002,216,477,693,0.3116883
G3601030111100,36,103,111100,290,774,1064,0.27255639
G3601030111201,36,103,111201,169,341,510,0.33137256
G3601030111202,36,103,111202,79,487,566,0.13957597
G3601030111300,36,103,111300,31,539,570,0.054385964
G3601030111401,36,103,111401,0,108,108,0
G3601030111402,36,103,111402,22,416,438,0.050228309
G3601030111503,36,103,111503,0,382,382,0
G3601030111504,36,103,111504,0,179,179,0
G3601030111505,36,103,111505,16,725,741,0.021592442
G3601030111506,36,103,111506,75,355,430,0.1744186
G3601030111601,36,103,111601,0,391,391,0
G3601030111602,36,103,111602,0,334,334,0
G3601030111701,36,103,111701,26,576,602,0.043189369
G3601030111703,36,103,111703,22,293,315,0.069841273
G3601030111704,36,103,111704,0,337,337,0
G3601030111801,36,103,111801,19,585,604,0.031456955
G3601030111802,36,103,111802,20,330,350,0.057142857
G3601030111803,36,103,111803,0,361,361,0
G3601030111804,36,103,111804,0,268,268,0
G3601030111900,36,103,111900,0,510,510,0
G3601030112001,36,103,112001,28,350,378,0.074074075
G3601030112002,36,103,112002,0,437,437,0
G3601030112102,36,103,112102,22,385,407,0.054054055
G3601030112103,36,103,112103,34,369,403,0.084367245
G3601030112104,36,103,112104,48,207,255,0.1882353
G3601030112204,36,103,112204,46,415,461,0.099783078
G3601030112206,36,103,112206,35,852,887,0.039458849
G3601030112210,36,103,112210,16,913,929,0.01722282
G3601030112211,36,103,112211,9,487,496,0.018145161
G3601030112212,36,103,112212,26,375,401,0.064837903
G3601030112213,36,103,112213,28,561,589,0.047538199
G3601030112214,36,103,112214,0,592,592,0
G3601030122300,36,103,122300,43,337,380,0.1131579
G3601030122403,36,103,122403,4,232,236,0.016949153
G3601030122404,36,103,122404,42,398,440,0.095454544
G3601030122405,36,103,122405,31,476,507,0.061143983
G3601030122406,36,103,122406,125,348,473,0.2642706
G3601030122501,36,103,122501,91,332,423,0.21513002
G3601030122502,36,103,122502,48,397,445,0.10786517
G3601030122601,36,103,122601,26,584,610,0.04262295
G3601030122602,36,103,122602,74,416,490,0.15102041
G3601030122603,36,103,122603,0,477,477,0
G3601030122704,36,103,122704,8,211,219,0.036529679
G3601030122705,36,103,122705,47,241,288,0.16319445
G3601030122706,36,103,122706,7,303,310,0.022580646
G3601030122707,36,103,122707,20,298,318,0.062893085
G3601030122801,36,103,122801,56,638,694,0.080691643
G3601030122802,36,103,122802,31,464,495,0.062626265
G3601030122901,36,103,122901,36,608,644,0.055900622
G3601030122902,36,103,122902,107,317,424,0.2523585
G3601030123001,36,103,123001,0,549,549,0
G3601030123002,36,103,123002,68,399,467,0.14561027
G3601030123101,36,103,123101,80,254,334,0.23952095
G3601030123102,36,103,123102,0,306,306,0
G3601030123201,36,103,123201,14,218,232,0.060344826
G3601030123202,36,103,123202,34,973,1007,0.033763655
G3601030123301,36,103,123301,54,640,694,0.077809796
G3601030123302,36,103,123302,17,217,234,0.072649576
G3601030123401,36,103,123401,7,480,487,0.014373717
G3601030123402,36,103,123402,102,625,727,0.14030261
G3601030123500,36,103,123500,70,403,473,0.14799154
G3601030123600,36,103,123600,0,246,246,0
G3601030123701,36,103,123701,142,516,658,0.21580547
G3601030123702,36,103,123702,14,588,602,0.023255814
G3601030123801,36,103,123801,0,236,236,0
G3601030123802,36,103,123802,23,258,281,0.081850536
G3601030123900,36,103,123900,16,539,555,0.02882883
G3601030124001,36,103,124001,63,456,519,0.12138728
G3601030124002,36,103,124002,0,383,383,0
G3601030124101,36,103,124101,49,300,349,0.14040114
G3601030124102,36,103,124102,63,236,299,0.21070234
G3601030124200,36,103,124200,31,428,459,0.067538127
G3601030124300,36,103,124300,44,595,639,0.068857588
G3601030124401,36,103,124401,0,241,241,0
G3601030124402,36,103,124402,0,326,326,0
G3601030124500,36,103,124500,14,545,559,0.025044722
G3601030124601,36,103,124601,14,238,252,0.055555556
G3601030124602,36,103,124602,44,293,337,0.1305638
G3601030134702,36,103,134702,13,346,359,0.036211699
G3601030134703,36,103,134703,31,425,456,0.067982458
G3601030134704,36,103,134704,36,215,251,0.1434263
G3601030134902,36,103,134902,84,379,463,0.18142548
G3601030134903,36,103,134903,0,118,118,0
G3601030134904,36,103,134904,8,747,755,0.010596027
G3601030134906,36,103,134906,0,548,548,0
G3601030134907,36,103,134907,32,385,417,0.076738611
G3601030135002,36,103,135002,76,492,568,0.13380282
G3601030135003,36,103,135003,7,546,553,0.012658228
G3601030135004,36,103,135004,12,300,312,0.03846154
G3601030135005,36,103,135005,15,257,272,0.055147059
G3601030135101,36,103,135101,20,340,360,0.055555556
G3601030135102,36,103,135102,24,514,538,0.044609666
G3601030135103,36,103,135103,0,553,553,0
G3601030135104,36,103,135104,23,706,729,0.031550068
G3601030135201,36,103,135201,34,237,271,0.12546125
G3601030135204,36,103,135204,0,475,475,0
G3601030135205,36,103,135205,41,535,576,0.071180552
G3601030135208,36,103,135208,4,364,368,0.010869565
G3601030135209,36,103,135209,0,316,316,0
G3601030135301,36,103,135301,34,377,411,0.082725063
G3601030135303,36,103,135303,0,407,407,0
G3601030135304,36,103,135304,0,293,293,0
G3601030135401,36,103,135401,37,731,768,0.048177082
G3601030135402,36,103,135402,51,808,859,0.059371363
G3601030135403,36,103,135403,10,566,576,0.017361112
G3601030145602,36,103,145602,159,638,797,0.19949812
G3601030145603,36,103,145603,161,630,791,0.20353982
G3601030145604,36,103,145604,70,541,611,0.11456628
G3601030145605,36,103,145605,13,370,383,0.033942558
G3601030145701,36,103,145701,11,524,535,0.020560747
G3601030145702,36,103,145702,15,600,615,0.024390243
G3601030145703,36,103,145703,96,434,530,0.18113208
G3601030145704,36,103,145704,14,660,674,0.020771513
G3601030145803,36,103,145803,34,415,449,0.075723834
G3601030145804,36,103,145804,5,337,342,0.014619883
G3601030145805,36,103,145805,7,579,586,0.011945393
G3601030145807,36,103,145807,20,490,510,0.039215688
G3601030145808,36,103,145808,40,306,346,0.11560693
G3601030145901,36,103,145901,43,352,395,0.10886076
G3601030145902,36,103,145902,193,818,1011,0.1909001
G3601030145903,36,103,145903,9,566,575,0.015652174
G3601030146001,36,103,146001,111,466,577,0.19237435
G3601030146002,36,103,146002,50,544,594,0.084175088
G3601030146003,36,103,146003,70,786,856,0.081775703
G3601030146102,36,103,146102,27,287,314,0.085987262
G3601030146103,36,103,146103,39,429,468,0.083333336
G3601030146105,36,103,146105,60,652,712,0.084269665
G3601030146106,36,103,146106,0,323,323,0
G3601030146201,36,103,146201,36,325,361,0.099722989
G3601030146202,36,103,146202,119,463,582,0.20446736
G3601030146203,36,103,146203,44,386,430,0.10232558
G3601030146204,36,103,146204,86,559,645,0.13333334
G3601030146205,36,103,146205,0,200,200,0
G3601030146206,36,103,146206,26,264,290,0.089655176
G3601030146300,36,103,146300,0,72,72,0
G3601030146402,36,103,146402,0,368,368,0
G3601030146403,36,103,146403,112,353,465,0.24086021
G3601030146404,36,103,146404,50,246,296,0.16891892
G3601030146500,36,103,146500,45,570,615,0.073170729
G3601030146604,36,103,146604,10,408,418,0.023923445
G3601030146605,36,103,146605,0,94,94,0
G3601030146606,36,103,146606,42,817,859,0.048894063
G3601030146607,36,103,146607,30,141,171,0.1754386
G3601030146608,36,103,146608,0,233,233,0
G3601030146611,36,103,146611,34,305,339,0.10029498
G3601030146612,36,103,146612,10,520,530,0.018867925
G3601030146613,36,103,146613,7,398,405,0.01728395
G3601030146614,36,103,146614,0,674,674,0
G3601030146615,36,103,146615,30,454,484,0.06198347
G3601030146703,36,103,146703,0,398,398,0
G3601030146704,36,103,146704,0,200,200,0
G3601030146705,36,103,146705,33,297,330,0.1
G3601030146706,36,103,146706,14,295,309,0.045307443
G3601030146800,36,103,146800,0,657,657,0
G3601030146901,36,103,146901,104,446,550,0.18909091
G3601030146902,36,103,146902,6,398,404,0.014851485
G3601030147001,36,103,147001,9,450,459,0.019607844
G3601030147003,36,103,147003,16,375,391,0.040920716
G3601030147004,36,103,147004,0,11,11,0
G3601030147100,36,103,147100,15,337,352,0.042613637
G3601030147200,36,103,147200,51,425,476,0.10714286
G3601030147300,36,103,147300,67,781,848,0.079009436
G3601030147401,36,103,147401,21,468,489,0.042944785
G3601030147402,36,103,147402,0,307,307,0
G3601030147501,36,103,147501,62,802,864,0.071759261
G3601030147502,36,103,147502,0,769,769,0
G3601030147503,36,103,147503,0,160,160,0
G3601030147601,36,103,147601,0,246,246,0
G3601030147602,36,103,147602,30,387,417,0.071942449
G3601030147701,36,103,147701,18,289,307,0.058631923
G3601030147702,36,103,147702,20,466,486,0.041152265
G3601030147802,36,103,147802,4,395,399,0.010025063
G3601030147803,36,103,147803,12,291,303,0.03960396
G3601030147804,36,103,147804,0,807,807,0
G3601030147901,36,103,147901,77,365,442,0.17420815
G3601030147902,36,103,147902,25,439,464,0.053879309
G3601030158001,36,103,158001,13,394,407,0.03194103
G3601030158002,36,103,158002,80,690,770,0.1038961
G3601030158006,36,103,158006,0,636,636,0
G3601030158007,36,103,158007,0,21,21,0
G3601030158009,36,103,158009,0,355,355,0
G3601030158010,36,103,158010,0,434,434,0
G3601030158011,36,103,158011,0,516,516,0
G3601030158102,36,103,158102,34,419,453,0.075055189
G3601030158103,36,103,158103,79,454,533,0.14821763
G3601030158104,36,103,158104,27,495,522,0.05172414
G3601030158107,36,103,158107,64,363,427,0.1498829
G3601030158108,36,103,158108,127,314,441,0.28798187
G3601030158110,36,103,158110,0,366,366,0
G3601030158111,36,103,158111,24,302,326,0.073619634
G3601030158112,36,103,158112,136,402,538,0.2527881
G3601030158114,36,103,158114,17,413,430,0.039534885
G3601030158115,36,103,158115,0,500,500,0
G3601030158116,36,103,158116,9,157,166,0.054216869
G3601030158202,36,103,158202,46,810,856,0.053738318
G3601030158203,36,103,158203,8,177,185,0.043243244
G3601030158205,36,103,158205,0,211,211,0
G3601030158206,36,103,158206,4,263,267,0.014981274
G3601030158207,36,103,158207,24,523,547,0.043875687
G3601030158304,36,103,158304,53,888,941,0.056323059
G3601030158306,36,103,158306,18,582,600,0.029999999
G3601030158308,36,103,158308,99,786,885,0.11186441
G3601030158309,36,103,158309,11,377,388,0.028350515
G3601030158310,36,103,158310,36,311,347,0.1037464
G3601030158315,36,103,158315,50,449,499,0.1002004
G3601030158317,36,103,158317,27,661,688,0.039244186
G3601030158318,36,103,158318,0,391,391,0
G3601030158319,36,103,158319,21,311,332,0.063253015
G3601030158320,36,103,158320,14,530,544,0.025735294
G3601030158321,36,103,158321,0,865,865,0
G3601030158322,36,103,158322,16,173,189,0.084656082
G3601030158323,36,103,158323,41,768,809,0.050679851
G3601030158401,36,103,158401,0,130,130,0
G3601030158402,36,103,158402,0,409,409,0
G3601030158403,36,103,158403,0,202,202,0
G3601030158405,36,103,158405,6,439,445,0.013483146
G3601030158407,36,103,158407,51,693,744,0.068548389
G3601030158408,36,103,158408,70,454,524,0.13358779
G3601030158409,36,103,158409,8,313,321,0.024922118
G3601030158410,36,103,158410,0,134,134,0
G3601030158502,36,103,158502,47,207,254,0.18503937
G3601030158505,36,103,158505,90,446,536,0.16791044
G3601030158506,36,103,158506,51,228,279,0.1827957
G3601030158507,36,103,158507,0,384,384,0
G3601030158508,36,103,158508,0,691,691,0
G3601030158509,36,103,158509,67,402,469,0.14285715
G3601030158510,36,103,158510,153,643,796,0.19221106
G3601030158511,36,103,158511,22,578,600,0.036666665
G3601030158512,36,103,158512,22,428,450,0.048888888
G3601030158604,36,103,158604,0,476,476,0
G3601030158605,36,103,158605,18,590,608,0.029605264
G3601030158606,36,103,158606,36,421,457,0.078774616
G3601030158607,36,103,158607,54,228,282,0.19148937
G3601030158608,36,103,158608,32,371,403,0.079404466
G3601030158609,36,103,158609,5,487,492,0.010162601
G3601030158704,36,103,158704,26,929,955,0.027225131
G3601030158705,36,103,158705,78,338,416,0.1875
G3601030158707,36,103,158707,0,157,157,0
G3601030158708,36,103,158708,44,255,299,0.14715719
G3601030158709,36,103,158709,34,129,163,0.20858896
G3601030158710,36,103,158710,30,317,347,0.08645533
G3601030158711,36,103,158711,20,459,479,0.041753653
G3601030158712,36,103,158712,86,748,834,0.1031175
G3601030158802,36,103,158802,48,484,532,0.090225562
G3601030158803,36,103,158803,0,728,728,0
G3601030158804,36,103,158804,0,663,663,0
G3601030158900,36,103,158900,249,537,786,0.31679389
G3601030159000,36,103,159000,139,266,405,0.34320986
G3601030159102,36,103,159102,33,413,446,0.07399103
G3601030159103,36,103,159103,306,426,732,0.4180328
G3601030159105,36,103,159105,48,640,688,0.069767445
G3601030159106,36,103,159106,21,551,572,0.036713287
G3601030159107,36,103,159107,30,412,442,0.067873307
G3601030159108,36,103,159108,0,866,866,0
G3601030159201,36,103,159201,0,348,348,0
G3601030159203,36,103,159203,99,417,516,0.19186047
G3601030159204,36,103,159204,56,386,442,0.12669684
G3601030159300,36,103,159300,18,102,120,0.15000001
G3601030159404,36,103,159404,151,684,835,0.18083832
G3601030159406,36,103,159406,18,369,387,0.046511628
G3601030159407,36,103,159407,42,614,656,0.064024389
G3601030159408,36,103,159408,24,235,259,0.092664093
G3601030159410,36,103,159410,95,1018,1113,0.085354894
G3601030159411,36,103,159411,79,339,418,0.18899521
G3601030159412,36,103,159412,28,752,780,0.035897437
G3601030159505,36,103,159505,92,745,837,0.10991637
G3601030159506,36,103,159506,179,767,946,0.18921776
G3601030159508,36,103,159508,163,906,1069,0.15247895
G3601030159509,36,103,159509,75,264,339,0.22123894
G3601030159510,36,103,159510,0,13,13,0
G3601030159511,36,103,159511,119,769,888,0.134009
G3601030159512,36,103,159512,23,189,212,0.10849056
G3601030159601,36,103,159601,0,564,564,0
G3601030159602,36,103,159602,0,397,397,0
G3601030169701,36,103,169701,42,615,657,0.063926943
G3601030169703,36,103,169703,8,157,165,0.048484847
G3601030169704,36,103,169704,0,412,412,0
G3601030169800,36,103,169800,151,281,432,0.34953704
G3601030169901,36,103,169901,109,481,590,0.18474576
G3601030169902,36,103,169902,0,257,257,0
G3601030170001,36,103,170001,17,536,553,0.03074141
G3601030170002,36,103,170002,10,335,345,0.028985508
G3601030170101,36,103,170101,20,130,150,0.13333334
G3601030170201,36,103,170201,61,434,495,0.12323232
G3601030170202,36,103,170202,45,181,226,0.19911504
G3601030180300,36,103,180300,0,246,246,0
G3601030190401,36,103,190401,68,560,628,0.10828026
G3601030190402,36,103,190402,12,231,243,0.049382716
G3601030190403,36,103,190403,0,412,412,0
G3601030190502,36,103,190502,6,154,160,0.037500001
G3601030190503,36,103,190503,0,284,284,0
G3601030190504,36,103,190504,0,163,163,0
G3601030190601,36,103,190601,0,448,448,0
G3601030190603,36,103,190603,9,429,438,0.020547945
G3601030190604,36,103,190604,18,191,209,0.086124405
G3601030190704,36,103,190704,0,217,217,0
G3601030190705,36,103,190705,18,325,343,0.052478135
G3601030190706,36,103,190706,34,379,413,0.082324453
G3601030190707,36,103,190707,142,374,516,0.27519381
G3601030190708,36,103,190708,0,102,102,0
G3601030190800,36,103,190800,62,195,257,0.24124514
G3601030200901,36,103,200901,0,72,72,0
G3601030200902,36,103,200902,52,541,593,0.087689713
G3601030201001,36,103,201001,66,471,537,0.12290503
G3601030201003,36,103,201003,27,454,481,0.056133058
G3601030201004,36,103,201004,76,136,212,0.35849056
G3601030201100,36,103,201100,53,584,637,0.083202511
G3601030990100,36,103,990100,0,0,0,
G3601050950100,36,105,950100,0,375,375,0
G3601050950200,36,105,950200,87,207,294,0.29591838
G3601050950300,36,105,950300,0,113,113,0
G3601050950400,36,105,950400,33,222,255,0.12941177
G3601050950500,36,105,950500,42,222,264,0.15909091
G3601050950600,36,105,950600,32,133,165,0.19393939
G3601050950700,36,105,950700,97,204,301,0.32225913
G3601050950800,36,105,950800,178,267,445,0.40000001
G3601050950900,36,105,950900,164,211,375,0.43733335
G3601050951000,36,105,951000,31,92,123,0.25203252
G3601050951100,36,105,951100,7,117,124,0.056451611
G3601050951200,36,105,951200,68,739,807,0.084262699
G3601050951300,36,105,951300,54,311,365,0.14794521
G3601050951500,36,105,951500,53,155,208,0.25480768
G3601050951600,36,105,951600,114,108,222,0.51351351
G3601050951700,36,105,951700,9,343,352,0.025568182
G3601050951800,36,105,951800,218,322,540,0.40370369
G3601050951900,36,105,951900,8,164,172,0.046511628
G3601050952000,36,105,952000,19,107,126,0.15079366
G3601050952100,36,105,952100,6,193,199,0.030150754
G3601050952200,36,105,952200,17,70,87,0.19540229
G3601050952300,36,105,952300,6,86,92,0.065217391
G3601050952400,36,105,952400,43,178,221,0.19457014
G3601050952500,36,105,952500,29,195,224,0.12946428
G3601070020100,36,107,20100,48,507,555,0.086486489
G3601070020200,36,107,20200,71,475,546,0.13003664
G3601070020300,36,107,20300,92,653,745,0.12348993
G3601070020401,36,107,20401,65,438,503,0.12922466
G3601070020402,36,107,20402,0,317,317,0
G3601070020500,36,107,20500,13,298,311,0.041800644
G3601070020600,36,107,20600,149,585,734,0.20299728
G3601070020701,36,107,20701,41,267,308,0.13311689
G3601070020702,36,107,20702,89,352,441,0.20181406
G3601070020703,36,107,20703,43,332,375,0.11466666
G3601090000100,36,109,100,0,34,34,0
G3601090000200,36,109,200,0,0,0,
G3601090000300,36,109,300,0,3,3,0
G3601090000400,36,109,400,0,38,38,0
G3601090000500,36,109,500,35,361,396,0.088383839
G3601090000600,36,109,600,0,219,219,0
G3601090000700,36,109,700,13,208,221,0.05882353
G3601090000800,36,109,800,81,102,183,0.44262296
G3601090000900,36,109,900,37,323,360,0.10277778
G3601090001000,36,109,1000,134,167,301,0.44518271
G3601090001100,36,109,1100,17,252,269,0.063197024
G3601090001200,36,109,1200,0,0,0,
G3601090001300,36,109,1300,0,314,314,0
G3601090001400,36,109,1400,11,309,320,0.034375001
G3601090001500,36,109,1500,187,630,817,0.22888617
G3601090001600,36,109,1600,91,342,433,0.21016166
G3601090001700,36,109,1700,167,345,512,0.32617188
G3601090001800,36,109,1800,61,222,283,0.2155477
G3601090001900,36,109,1900,45,499,544,0.082720585
G3601090002000,36,109,2000,30,313,343,0.087463558
G3601090002100,36,109,2100,63,371,434,0.14516129
G3601090002200,36,109,2200,39,357,396,0.098484851
G3601090002300,36,109,2300,71,414,485,0.14639175
G3601110950100,36,111,950100,22,488,510,0.043137256
G3601110950200,36,111,950200,8,291,299,0.026755853
G3601110950300,36,111,950300,57,524,581,0.098106712
G3601110950400,36,111,950400,7,285,292,0.023972603
G3601110950500,36,111,950500,33,170,203,0.16256158
G3601110950600,36,111,950600,0,196,196,0
G3601110950900,36,111,950900,8,73,81,0.098765433
G3601110951000,36,111,951000,41,277,318,0.12893082
G3601110951100,36,111,951100,36,205,241,0.1493776
G3601110951200,36,111,951200,25,258,283,0.088339224
G3601110951300,36,111,951300,29,219,248,0.11693548
G3601110951400,36,111,951400,77,240,317,0.2429022
G3601110951500,36,111,951500,3,258,261,0.011494253
G3601110951600,36,111,951600,0,202,202,0
G3601110951700,36,111,951700,132,211,343,0.38483965
G3601110951800,36,111,951800,37,140,177,0.20903955
G3601110951900,36,111,951900,163,129,292,0.55821919
G3601110952000,36,111,952000,33,131,164,0.20121951
G3601110952100,36,111,952100,126,271,397,0.31738034
G3601110952200,36,111,952200,75,186,261,0.28735632
G3601110952300,36,111,952300,0,173,173,0
G3601110952400,36,111,952400,10,188,198,0.05050505
G3601110952500,36,111,952500,0,324,324,0
G3601110952600,36,111,952600,0,393,393,0
G3601110952700,36,111,952700,36,220,256,0.140625
G3601110952800,36,111,952800,0,217,217,0
G3601110952900,36,111,952900,132,489,621,0.21256039
G3601110953000,36,111,953000,0,132,132,0
G3601110953300,36,111,953300,17,452,469,0.036247335
G3601110953400,36,111,953400,25,269,294,0.085034013
G3601110953500,36,111,953500,12,147,159,0.075471699
G3601110953600,36,111,953600,78,416,494,0.15789473
G3601110953700,36,111,953700,28,505,533,0.052532833
G3601110953800,36,111,953800,0,406,406,0
G3601110953900,36,111,953900,28,531,559,0.050089445
G3601110954000,36,111,954000,58,299,357,0.16246499
G3601110954100,36,111,954100,112,551,663,0.16892911
G3601110954200,36,111,954200,16,540,556,0.028776979
G3601110954400,36,111,954400,0,768,768,0
G3601110954500,36,111,954500,25,177,202,0.12376238
G3601110954600,36,111,954600,27,175,202,0.13366337
G3601110954700,36,111,954700,27,162,189,0.14285715
G3601110954800,36,111,954800,112,520,632,0.17721519
G3601110954900,36,111,954900,22,93,115,0.19130434
G3601110955000,36,111,955000,61,409,470,0.12978724
G3601110955300,36,111,955300,6,150,156,0.03846154
G3601110955400,36,111,955400,60,312,372,0.16129032
G3601130070100,36,113,70100,11,165,176,0.0625
G3601130070200,36,113,70200,89,120,209,0.42583731
G3601130070300,36,113,70300,49,237,286,0.17132868
G3601130070400,36,113,70400,65,283,348,0.18678162
G3601130070500,36,113,70500,42,103,145,0.28965518
G3601130070601,36,113,70601,18,349,367,0.049046323
G3601130070602,36,113,70602,21,90,111,0.1891892
G3601130070701,36,113,70701,24,249,273,0.08791209
G3601130070702,36,113,70702,19,420,439,0.043280181
G3601130070800,36,113,70800,179,684,863,0.207416
G3601130070900,36,113,70900,24,471,495,0.048484847
G3601130071000,36,113,71000,20,198,218,0.091743119
G3601130072000,36,113,72000,63,179,242,0.26033059
G3601130073000,36,113,73000,32,277,309,0.10355987
G3601130073500,36,113,73500,36,126,162,0.22222222
G3601130074000,36,113,74000,39,107,146,0.26712328
G3601130075000,36,113,75000,43,226,269,0.1598513
G3601130076000,36,113,76000,52,109,161,0.32298136
G3601130078000,36,113,78000,0,125,125,0
G3601150080100,36,115,80100,213,227,440,0.48409089
G3601150080200,36,115,80200,64,193,257,0.24902724
G3601150080300,36,115,80300,87,521,608,0.14309211
G3601150081000,36,115,81000,9,369,378,0.023809524
G3601150082001,36,115,82001,188,351,539,0.34879407
G3601150082002,36,115,82002,25,108,133,0.18796992
G3601150084000,36,115,84000,149,542,691,0.21562952
G3601150085000,36,115,85000,28,216,244,0.1147541
G3601150086000,36,115,86000,52,108,160,0.32499999
G3601150087000,36,115,87000,57,231,288,0.19791667
G3601150088000,36,115,88000,54,554,608,0.088815786
G3601150089000,36,115,89000,22,442,464,0.047413792
G3601150090000,36,115,90000,58,182,240,0.24166666
G3601150091000,36,115,91000,17,123,140,0.12142857
G3601150092000,36,115,92000,31,261,292,0.10616438
G3601150093000,36,115,93000,3,179,182,0.016483517
G3601150094000,36,115,94000,18,185,203,0.088669948
G3601170020101,36,117,20101,0,621,621,0
G3601170020102,36,117,20102,67,396,463,0.14470842
G3601170020201,36,117,20201,25,500,525,0.047619049
G3601170020202,36,117,20202,0,565,565,0
G3601170020301,36,117,20301,45,335,380,0.11842106
G3601170020302,36,117,20302,4,467,471,0.008492569
G3601170020401,36,117,20401,0,193,193,0
G3601170020402,36,117,20402,86,291,377,0.22811671
G3601170020500,36,117,20500,25,374,399,0.062656641
G3601170020600,36,117,20600,79,311,390,0.20256411
G3601170020700,36,117,20700,24,246,270,0.088888891
G3601170020800,36,117,20800,47,142,189,0.24867725
G3601170020900,36,117,20900,151,366,517,0.29206964
G3601170021000,36,117,21000,95,448,543,0.17495395
G3601170021100,36,117,21100,35,276,311,0.11254019
G3601170021200,36,117,21200,105,300,405,0.25925925
G3601170021400,36,117,21400,118,224,342,0.34502923
G3601170021501,36,117,21501,18,158,176,0.10227273
G3601170021502,36,117,21502,51,374,425,0.12
G3601170021600,36,117,21600,93,325,418,0.22248805
G3601170021700,36,117,21700,68,347,415,0.16385542
G3601170021800,36,117,21800,57,169,226,0.25221238
G3601170990100,36,117,990100,0,0,0,
G3601190000101,36,119,101,229,296,525,0.43619049
G3601190000103,36,119,103,131,498,629,0.20826709
G3601190000104,36,119,104,0,0,0,
G3601190000201,36,119,201,178,887,1065,0.16713615
G3601190000202,36,119,202,67,227,294,0.22789116
G3601190000203,36,119,203,50,275,325,0.15384616
G3601190000300,36,119,300,219,202,421,0.52019
G3601190000401,36,119,401,189,189,378,0.5
G3601190000402,36,119,402,148,230,378,0.39153439
G3601190000500,36,119,500,78,283,361,0.21606648
G3601190000600,36,119,600,235,529,764,0.30759162
G3601190000701,36,119,701,57,241,298,0.19127516
G3601190000702,36,119,702,73,420,493,0.14807302
G3601190000801,36,119,801,0,599,599,0
G3601190000802,36,119,802,63,240,303,0.20792079
G3601190000803,36,119,803,57,280,337,0.16913946
G3601190000900,36,119,900,33,190,223,0.14798206
G3601190001000,36,119,1000,89,119,208,0.42788461
G3601190001101,36,119,1101,296,224,520,0.56923079
G3601190001102,36,119,1102,246,394,640,0.38437501
G3601190001200,36,119,1200,155,252,407,0.38083538
G3601190001301,36,119,1301,25,247,272,0.091911763
G3601190001302,36,119,1302,198,281,479,0.41336116
G3601190001303,36,119,1303,401,364,765,0.52418303
G3601190001401,36,119,1401,16,320,336,0.047619049
G3601190001402,36,119,1402,22,153,175,0.12571429
G3601190001403,36,119,1403,26,387,413,0.062953994
G3601190001502,36,119,1502,38,247,285,0.13333334
G3601190001503,36,119,1503,0,267,267,0
G3601190001504,36,119,1504,0,431,431,0
G3601190001505,36,119,1505,12,153,165,0.07272727
G3601190001600,36,119,1600,99,146,245,0.40408164
G3601190001700,36,119,1700,44,719,763,0.057667103
G3601190001800,36,119,1800,32,134,166,0.19277108
G3601190001900,36,119,1900,0,171,171,0
G3601190002000,36,119,2000,18,407,425,0.042352941
G3601190002101,36,119,2101,16,297,313,0.05111821
G3601190002103,36,119,2103,7,314,321,0.021806853
G3601190002104,36,119,2104,9,340,349,0.025787966
G3601190002105,36,119,2105,0,166,166,0
G3601190002106,36,119,2106,14,261,275,0.050909091
G3601190002107,36,119,2107,14,139,153,0.09150327
G3601190002201,36,119,2201,4,291,295,0.013559322
G3601190002202,36,119,2202,20,230,250,0.079999998
G3601190002203,36,119,2203,12,39,51,0.23529412
G3601190002204,36,119,2204,23,176,199,0.11557789
G3601190002300,36,119,2300,81,300,381,0.21259843
G3601190002401,36,119,2401,20,85,105,0.19047619
G3601190002402,36,119,2402,59,304,363,0.16253443
G3601190002403,36,119,2403,75,220,295,0.25423729
G3601190002404,36,119,2404,55,184,239,0.23012552
G3601190002405,36,119,2405,74,265,339,0.21828909
G3601190002600,36,119,2600,113,350,463,0.24406047
G3601190002700,36,119,2700,266,247,513,0.51851851
G3601190002800,36,119,2800,51,193,244,0.2090164
G3601190002900,36,119,2900,95,438,533,0.1782364
G3601190003000,36,119,3000,2,322,324,0.00617284
G3601190003100,36,119,3100,77,268,345,0.2231884
G3601190003200,36,119,3200,54,187,241,0.22406639
G3601190003300,36,119,3300,75,288,363,0.20661157
G3601190003400,36,119,3400,28,422,450,0.062222224
G3601190003500,36,119,3500,105,145,250,0.41999999
G3601190003600,36,119,3600,108,304,412,0.26213592
G3601190003700,36,119,3700,169,346,515,0.32815534
G3601190003800,36,119,3800,39,127,166,0.23493975
G3601190003900,36,119,3900,7,213,220,0.031818181
G3601190004000,36,119,4000,0,482,482,0
G3601190004100,36,119,4100,84,310,394,0.21319798
G3601190004200,36,119,4200,90,233,323,0.27863777
G3601190004300,36,119,4300,24,88,112,0.21428572
G3601190004400,36,119,4400,11,258,269,0.040892195
G3601190004500,36,119,4500,5,74,79,0.06329114
G3601190004600,36,119,4600,0,380,380,0
G3601190004700,36,119,4700,30,480,510,0.05882353
G3601190004800,36,119,4800,31,501,532,0.058270678
G3601190004900,36,119,4900,0,159,159,0
G3601190005001,36,119,5001,0,413,413,0
G3601190005002,36,119,5002,0,434,434,0
G3601190005100,36,119,5100,39,408,447,0.087248325
G3601190005200,36,119,5200,21,573,594,0.035353534
G3601190005300,36,119,5300,0,634,634,0
G3601190005400,36,119,5400,0,188,188,0
G3601190005500,36,119,5500,12,659,671,0.017883755
G3601190005600,36,119,5600,0,0,0,
G3601190005701,36,119,5701,65,453,518,0.12548262
G3601190005702,36,119,5702,16,159,175,0.09142857
G3601190005800,36,119,5800,0,419,419,0
G3601190005901,36,119,5901,105,332,437,0.24027459
G3601190005902,36,119,5902,0,471,471,0
G3601190006000,36,119,6000,44,189,233,0.18884121
G3601190006100,36,119,6100,43,219,262,0.16412213
G3601190006200,36,119,6200,248,513,761,0.32588699
G3601190006300,36,119,6300,49,392,441,0.11111111
G3601190006400,36,119,6400,55,653,708,0.077683613
G3601190006500,36,119,6500,244,484,728,0.33516484
G3601190006600,36,119,6600,9,629,638,0.014106583
G3601190006700,36,119,6700,0,588,588,0
G3601190006801,36,119,6801,30,567,597,0.050251257
G3601190006802,36,119,6802,0,516,516,0
G3601190006900,36,119,6900,0,806,806,0
G3601190007000,36,119,7000,0,617,617,0
G3601190007100,36,119,7100,46,693,739,0.062246278
G3601190007200,36,119,7200,64,656,720,0.088888891
G3601190007300,36,119,7300,143,374,517,0.27659574
G3601190007401,36,119,7401,0,472,472,0
G3601190007402,36,119,7402,0,402,402,0
G3601190007500,36,119,7500,0,701,701,0
G3601190007600,36,119,7600,0,838,838,0
G3601190007700,36,119,7700,56,463,519,0.10789981
G3601190007800,36,119,7800,155,401,556,0.27877697
G3601190007900,36,119,7900,176,693,869,0.20253165
G3601190008000,36,119,8000,116,381,497,0.2334004
G3601190008100,36,119,8100,84,281,365,0.23013699
G3601190008200,36,119,8200,0,686,686,0
G3601190008301,36,119,8301,85,257,342,0.24853802
G3601190008302,36,119,8302,15,803,818,0.018337408
G3601190008401,36,119,8401,30,281,311,0.096463025
G3601190008403,36,119,8403,51,426,477,0.10691824
G3601190008404,36,119,8404,88,590,678,0.12979351
G3601190008500,36,119,8500,9,341,350,0.025714286
G3601190008602,36,119,8602,48,525,573,0.083769634
G3601190008700,36,119,8700,76,289,365,0.20821919
G3601190008800,36,119,8800,37,229,266,0.13909775
G3601190008901,36,119,8901,15,385,400,0.037500001
G3601190008902,36,119,8902,92,363,455,0.20219781
G3601190009000,36,119,9000,56,286,342,0.16374269
G3601190009100,36,119,9100,34,479,513,0.066276804
G3601190009200,36,119,9200,140,681,821,0.17052375
G3601190009300,36,119,9300,167,198,365,0.45753425
G3601190009400,36,119,9400,79,192,271,0.29151291
G3601190009500,36,119,9500,67,354,421,0.15914489
G3601190009600,36,119,9600,54,475,529,0.10207939
G3601190009701,36,119,9701,40,266,306,0.13071896
G3601190009702,36,119,9702,14,169,183,0.076502733
G3601190009703,36,119,9703,18,322,340,0.052941177
G3601190009800,36,119,9800,0,728,728,0
G3601190009900,36,119,9900,23,434,457,0.050328229
G3601190010000,36,119,10000,0,723,723,0
G3601190010100,36,119,10100,34,656,690,0.049275361
G3601190010200,36,119,10200,0,632,632,0
G3601190010300,36,119,10300,0,281,281,0
G3601190010400,36,119,10400,8,223,231,0.034632035
G3601190010500,36,119,10500,0,654,654,0
G3601190010600,36,119,10600,14,496,510,0.027450981
G3601190010701,36,119,10701,28,685,713,0.039270688
G3601190010702,36,119,10702,0,624,624,0
G3601190010801,36,119,10801,6,326,332,0.018072288
G3601190010803,36,119,10803,0,164,164,0
G3601190010804,36,119,10804,18,221,239,0.075313807
G3601190010901,36,119,10901,26,214,240,0.10833333
G3601190010902,36,119,10902,0,527,527,0
G3601190010903,36,119,10903,73,446,519,0.1406551
G3601190011000,36,119,11000,7,191,198,0.035353534
G3601190011101,36,119,11101,0,655,655,0
G3601190011102,36,119,11102,18,287,305,0.059016392
G3601190011200,36,119,11200,40,386,426,0.093896717
G3601190011300,36,119,11300,43,813,856,0.050233644
G3601190011400,36,119,11400,0,581,581,0
G3601190011500,36,119,11500,0,461,461,0
G3601190011600,36,119,11600,197,517,714,0.27591038
G3601190011700,36,119,11700,29,359,388,0.074742265
G3601190011800,36,119,11800,12,723,735,0.01632653
G3601190011902,36,119,11902,22,451,473,0.046511628
G3601190012000,36,119,12000,8,449,457,0.017505471
G3601190012101,36,119,12101,14,607,621,0.022544283
G3601190012102,36,119,12102,5,422,427,0.011709602
G3601190012200,36,119,12200,0,685,685,0
G3601190012301,36,119,12301,4,213,217,0.01843318
G3601190012303,36,119,12303,6,636,642,0.009345794
G3601190012304,36,119,12304,0,621,621,0
G3601190012400,36,119,12400,0,603,603,0
G3601190012501,36,119,12501,13,346,359,0.036211699
G3601190012502,36,119,12502,66,679,745,0.088590607
G3601190012503,36,119,12503,0,412,412,0
G3601190012600,36,119,12600,14,587,601,0.023294508
G3601190012700,36,119,12700,0,570,570,0
G3601190012802,36,119,12802,99,811,910,0.10879121
G3601190012900,36,119,12900,86,384,470,0.18297872
G3601190013000,36,119,13000,81,520,601,0.13477537
G3601190013102,36,119,13102,95,798,893,0.10638298
G3601190013103,36,119,13103,0,611,611,0
G3601190013104,36,119,13104,0,782,782,0
G3601190013201,36,119,13201,5,487,492,0.010162601
G3601190013202,36,119,13202,11,323,334,0.032934133
G3601190013301,36,119,13301,111,291,402,0.27611941
G3601190013304,36,119,13304,102,408,510,0.2
G3601190013400,36,119,13400,362,589,951,0.38065195
G3601190013500,36,119,13500,27,441,468,0.057692308
G3601190013600,36,119,13600,30,439,469,0.063965887
G3601190013700,36,119,13700,21,384,405,0.05185185
G3601190013800,36,119,13800,8,395,403,0.019851116
G3601190013900,36,119,13900,27,511,538,0.050185874
G3601190014000,36,119,14000,34,251,285,0.11929824
G3601190014100,36,119,14100,67,463,530,0.12641509
G3601190014200,36,119,14200,23,235,258,0.089147285
G3601190014300,36,119,14300,96,341,437,0.21967964
G3601190014400,36,119,14400,49,496,545,0.089908257
G3601190014500,36,119,14500,0,352,352,0
G3601190014604,36,119,14604,73,404,477,0.15303983
G3601190014605,36,119,14605,0,146,146,0
G3601190014606,36,119,14606,19,673,692,0.027456647
G3601190014607,36,119,14607,0,575,575,0
G3601190014701,36,119,14701,40,468,508,0.078740157
G3601190014703,36,119,14703,40,557,597,0.067001678
G3601190014704,36,119,14704,50,232,282,0.17730497
G3601190014804,36,119,14804,44,778,822,0.053527981
G3601190014805,36,119,14805,12,420,432,0.027777778
G3601190014806,36,119,14806,0,693,693,0
G3601190014808,36,119,14808,0,315,315,0
G3601190014809,36,119,14809,0,681,681,0
G3601190014810,36,119,14810,0,106,106,0
G3601190014811,36,119,14811,0,742,742,0
G3601190014901,36,119,14901,9,842,851,0.010575793
G3601190014903,36,119,14903,0,282,282,0
G3601190014907,36,119,14907,0,471,471,0
G3601190014908,36,119,14908,4,398,402,0.009950249
G3601190014909,36,119,14909,0,290,290,0
G3601190015000,36,119,15000,44,456,500,0.088
G3601190981000,36,119,981000,0,50,50,0
G3601190982000,36,119,982000,0,0,0,
G3601190983000,36,119,983000,0,0,0,
G3601190984000,36,119,984000,0,19,19,0
G3601190985000,36,119,985000,0,0,0,
G3601210970100,36,121,970100,39,201,240,0.16249999
G3601210970200,36,121,970200,42,335,377,0.11140583
G3601210970300,36,121,970300,12,238,250,0.048
G3601210970400,36,121,970400,34,316,350,0.09714286
G3601210970500,36,121,970500,163,322,485,0.33608249
G3601210970600,36,121,970600,162,338,500,0.324
G3601210970700,36,121,970700,36,207,243,0.14814815
G3601210970800,36,121,970800,40,254,294,0.13605443
G3601210970900,36,121,970900,9,152,161,0.055900622
G3601210971000,36,121,971000,96,388,484,0.19834711
G3601210971100,36,121,971100,50,206,256,0.1953125
G3601230150100,36,123,150100,68,450,518,0.13127413
G3601230150200,36,123,150200,126,419,545,0.23119266
G3601230150300,36,123,150300,95,457,552,0.17210145
G3601230150400,36,123,150400,21,146,167,0.1257485
G3601230150500,36,123,150500,87,351,438,0.19863014